{
{ 0, 0, 0, 0, 0, 0, 0, 0, 0, 0, 0, 0, 0, 0, 0, 0, 
0, 0, 0, 0, 0, 0, 0, 0, 0, 0, 0, 0, 0, 0, 0, 0, 
0, 0, 0, 0, 0, 0, 0, 0 },
{ 0, 0, 0, 0, 0, 0, 0, 0, 0, 0, 0, 0, 0, 0, 0, 0, 
0, 0, 0, 0, 0, 0, 0, 0, 0, 0, 0, 0, 0, 0, 0, 0, 
0, 0, 0, 0, 0, 0, 0, 0 },
{ 0, 0, 0, 0, 0, 0, 0, 0, 0, 0, 0, 0, 0, 0, 0, 0, 
0, 0, 0, 0, 0, 0, 0, 0, 0, 0, 0, 0, 0, 0, 0, 0, 
0, 0, 0, 0, 0, 0, 0, 0 },
{ 0, 0, 0, 0, 0, 0, 0, 0, 0, 0, 0, 0, 0, 0, 0, 0, 
0, 0, 0, 0, 0, 0, 0, 0, 0, 0, 0, 0, 0, 0, 0, 0, 
0, 0, 0, 0, 0, 0, 0, 0 },
{ 0, 0, 0, 0, 0, 0, 0, 0, 0, 0, 0, 0, 0, 0, 0, 0, 
0, 0, 0, 0, 0, 0, 0, 0, 0, 0, 0, 0, 0, 0, 0, 0, 
0, 0, 0, 0, 0, 0, 0, 0 },
{ 0, 0, 0, 0, 0, 0, 0, 0, 0, 0, 0, 0, 0, 0, 0, 0, 
0, 0, 0, 0, 0, 0, 0, 0, 0, 0, 0, 0, 0, 0, 0, 0, 
0, 0, 0, 0, 0, 0, 0, 0 },
{ 0, 0, 0, 0, 0, 0, 0, 0, 0, 0, 0, 0, 0, 0, 0, 0, 
0, 0, 0, 0, 0, 0, 0, 0, 0, 0, 0, 0, 0, 0, 0, 0, 
0, 0, 0, 0, 0, 0, 0, 0 },
{ 0, 0, 0, 0, 0, 0, 0, 0, 0, 0, 0, 0, 0, 0, 0, 0, 
0, 0, 0, 0, 0, 0, 0, 0, 0, 0, 0, 0, 0, 0, 0, 0, 
0, 0, 0, 0, 0, 0, 0, 0 },
{ 0, 0, 0, 0, 0, 0, 0, 0, 0, 0, 0, 0, 0, 0, 0, 0, 
0, 0, 0, 0, 0, 0, 0, 0, 0, 0, 0, 0, 0, 0, 0, 0, 
0, 0, 0, 0, 0, 0, 0, 0 },
{ 0, 0, 0, 0, 0, 0, 0, 0, 0, 0, 0, 0, 0, 0, 0, 0, 
0, 0, 0, 0, 0, 0, 0, 0, 0, 0, 0, 0, 0, 0, 0, 0, 
0, 0, 0, 0, 0, 0, 0, 0 },
{ 0, 0, 0, 0, 0, 0, 0, 0, 0, 0, 0, 0, 0, 0, 0, 0, 
0, 0, 0, 0, 0, 0, 0, 0, 0, 0, 0, 0, 0, 0, 0, 0, 
0, 0, 0, 0, 0, 0, 0, 0 },
{ 0, 0, 0, 0, 0, 0, 0, 0, 0, 0, 0, 0, 0, 0, 0, 0, 
0, 0, 0, 0, 0, 0, 0, 0, 0, 0, 0, 0, 0, 0, 0, 0, 
0, 0, 0, 0, 0, 0, 0, 0 },
{ 0, 0, 0, 0, 0, 0, 0, 0, 0, 0, 0, 0, 0, 0, 0, 0, 
0, 0, 0, 0, 0, 0, 0, 0, 0, 0, 0, 0, 0, 0, 0, 0, 
0, 0, 0, 0, 0, 0, 0, 0 },
{ 0, 0, 0, 0, 0, 0, 0, 0, 0, 0, 0, 0, 0, 0, 4, 4, 
0, 0, 0, 0, 0, 0, 0, 0, 0, 0, 0, 0, 0, 0, 0, 0, 
0, 0, 0, 0, 0, 0, 0, 0 },
{ 0, 0, 0, 0, 0, 0, 0, 0, 0, 0, 0, 0, 4, 4, 4, 4, 
4, 0, 0, 0, 0, 0, 0, 0, 0, 0, 0, 0, 0, 0, 0, 0, 
0, 0, 0, 0, 0, 0, 0, 0 },
{ 0, 0, 0, 0, 0, 0, 0, 0, 0, 0, 0, 0, 4, 4, 4, 4, 
4, 0, 0, 0, 0, 0, 0, 0, 0, 0, 0, 0, 0, 0, 0, 0, 
0, 0, 0, 0, 0, 0, 0, 0 },
{ 0, 0, 0, 0, 0, 0, 0, 0, 0, 0, 0, 0, 0, 4, 4, 4, 
0, 0, 0, 0, 0, 0, 0, 0, 0, 0, 0, 0, 0, 0, 0, 0, 
0, 0, 0, 0, 0, 0, 0, 0 },
{ 0, 0, 0, 0, 0, 0, 0, 0, 0, 0, 0, 0, 0, 0, 0, 0, 
0, 0, 0, 0, 0, 0, 0, 0, 0, 0, 0, 0, 0, 0, 0, 0, 
0, 0, 0, 0, 0, 0, 0, 0 },
{ 0, 0, 0, 0, 0, 0, 0, 0, 0, 0, 0, 0, 0, 0, 0, 0, 
0, 0, 0, 0, 0, 0, 0, 0, 0, 0, 0, 0, 0, 0, 0, 0, 
0, 0, 0, 0, 0, 0, 0, 0 },
{ 0, 0, 0, 0, 0, 0, 0, 0, 0, 0, 0, 0, 0, 0, 0, 0, 
0, 0, 0, 0, 0, 0, 0, 0, 0, 0, 0, 0, 0, 0, 0, 0, 
0, 0, 0, 0, 0, 0, 0, 0 },
{ 0, 0, 0, 0, 0, 0, 0, 0, 0, 0, 0, 0, 0, 0, 0, 0, 
0, 0, 0, 0, 0, 0, 0, 0, 0, 0, 0, 0, 0, 0, 0, 0, 
0, 0, 0, 0, 0, 0, 0, 0 },
{ 0, 0, 0, 0, 0, 0, 0, 0, 0, 0, 0, 0, 0, 0, 0, 0, 
0, 0, 0, 0, 0, 0, 0, 0, 0, 0, 0, 0, 0, 0, 0, 0, 
0, 0, 0, 0, 0, 0, 0, 0 },
{ 0, 0, 0, 0, 0, 0, 0, 0, 0, 0, 0, 0, 0, 0, 0, 0, 
0, 0, 0, 0, 0, 0, 0, 0, 0, 0, 0, 0, 0, 0, 0, 0, 
0, 0, 0, 0, 0, 0, 0, 0 },
{ 0, 0, 0, 0, 0, 0, 0, 0, 0, 0, 0, 0, 0, 0, 0, 0, 
0, 0, 0, 0, 0, 0, 0, 0, 0, 0, 0, 0, 0, 0, 0, 0, 
0, 0, 0, 0, 0, 0, 0, 0 },
{ 0, 0, 0, 0, 0, 0, 0, 0, 0, 0, 0, 0, 0, 0, 0, 0, 
0, 0, 0, 0, 0, 0, 0, 0, 0, 0, 0, 0, 0, 0, 0, 0, 
0, 0, 0, 0, 0, 0, 0, 0 },
{ 0, 0, 0, 0, 0, 0, 0, 0, 0, 0, 0, 0, 0, 0, 0, 0, 
0, 0, 0, 0, 0, 0, 0, 0, 0, 0, 0, 0, 0, 0, 0, 0, 
0, 0, 0, 0, 0, 0, 0, 0 },
{ 0, 0, 0, 0, 0, 0, 0, 0, 0, 0, 0, 0, 0, 0, 0, 0, 
0, 0, 0, 0, 0, 0, 0, 0, 0, 0, 0, 0, 0, 0, 0, 0, 
0, 0, 0, 0, 0, 0, 0, 0 },
{ 0, 0, 0, 0, 0, 0, 0, 0, 0, 0, 0, 0, 0, 0, 0, 0, 
0, 0, 0, 0, 0, 0, 0, 0, 0, 0, 0, 0, 0, 0, 0, 0, 
0, 0, 0, 0, 0, 0, 0, 0 },
{ 0, 0, 0, 0, 0, 0, 0, 0, 0, 0, 0, 0, 0, 0, 0, 0, 
0, 0, 0, 0, 0, 0, 0, 0, 0, 0, 0, 0, 0, 0, 0, 0, 
0, 0, 0, 0, 0, 0, 0, 0 },
{ 0, 0, 0, 0, 0, 0, 0, 0, 0, 0, 0, 0, 0, 0, 0, 0, 
0, 0, 0, 0, 0, 0, 0, 0, 0, 0, 0, 0, 0, 0, 0, 0, 
0, 0, 0, 0, 0, 0, 0, 0 },
{ 0, 0, 0, 0, 0, 0, 0, 0, 0, 0, 0, 0, 0, 0, 0, 0, 
0, 0, 0, 0, 0, 0, 0, 0, 0, 0, 0, 0, 0, 0, 0, 0, 
0, 0, 0, 0, 0, 0, 0, 0 },
{ 4, 0, 0, 0, 0, 0, 0, 0, 0, 0, 0, 0, 0, 0, 0, 0, 
0, 0, 0, 0, 0, 0, 0, 0, 0, 0, 0, 0, 0, 0, 0, 0, 
0, 0, 0, 0, 0, 0, 0, 0 },
{ 4, 4, 0, 0, 0, 0, 0, 0, 0, 0, 0, 0, 0, 0, 0, 0, 
0, 0, 0, 0, 0, 0, 0, 0, 0, 0, 0, 0, 0, 0, 0, 0, 
0, 0, 0, 0, 0, 0, 0, 0 },
{ 4, 4, 0, 0, 0, 0, 0, 0, 0, 0, 0, 0, 0, 0, 0, 0, 
0, 0, 0, 0, 0, 0, 0, 0, 0, 0, 0, 0, 0, 0, 0, 0, 
0, 0, 0, 0, 0, 0, 0, 0 },
{ 4, 4, 4, 0, 0, 0, 0, 0, 0, 0, 0, 0, 0, 0, 0, 0, 
0, 0, 0, 0, 0, 0, 0, 0, 0, 0, 0, 0, 0, 0, 0, 0, 
0, 0, 0, 0, 0, 0, 0, 0 },
{ 4, 4, 4, 4, 0, 0, 0, 0, 0, 0, 0, 0, 0, 0, 0, 0, 
0, 0, 0, 0, 0, 0, 0, 0, 0, 0, 0, 0, 0, 0, 0, 0, 
0, 0, 0, 0, 0, 0, 0, 0 },
{ 4, 4, 4, 4, 0, 0, 0, 0, 0, 0, 0, 0, 0, 0, 0, 0, 
0, 0, 0, 0, 0, 0, 0, 0, 0, 0, 0, 0, 0, 0, 0, 0, 
0, 0, 0, 0, 0, 0, 0, 0 },
{ 4, 4, 4, 4, 0, 0, 0, 0, 0, 0, 0, 0, 0, 0, 0, 0, 
0, 0, 0, 0, 0, 0, 0, 0, 0, 0, 0, 0, 0, 0, 0, 0, 
0, 0, 0, 0, 0, 0, 0, 0 },
{ 4, 4, 4, 4, 0, 0, 0, 0, 0, 0, 0, 0, 0, 0, 0, 0, 
0, 0, 0, 0, 0, 0, 0, 0, 0, 0, 0, 0, 0, 0, 0, 0, 
0, 0, 0, 0, 0, 0, 0, 0 },
{ 4, 4, 4, 4, 0, 0, 0, 0, 0, 0, 0, 0, 0, 0, 0, 0, 
0, 0, 0, 0, 0, 0, 0, 0, 0, 0, 0, 0, 0, 0, 0, 0, 
0, 0, 0, 0, 0, 0, 0, 0 }
};
 {
{ 1, 1, 1, 1, 1, 1, 1, 1, 1, 1, 1, 1, 1, 1, 1, 1, 
1, 19, 16, 16, 16, 16, 16, 16, 16, 16, 1, 1, 1, 1, 1, 1, 
1, 1, 1, 1, 1, 1, 1, 1 },
{ 1, 1, 1, 1, 1, 1, 1, 1, 1, 1, 1, 1, 1, 1, 1, 1, 
1, 1, 19, 16, 16, 16, 16, 16, 16, 6, 1, 1, 1, 1, 1, 1, 
1, 1, 1, 1, 1, 1, 1, 1 },
{ 1, 1, 1, 1, 1, 1, 1, 1, 1, 1, 1, 1, 3, 3, 1, 1, 
1, 1, 1, 19, 16, 16, 16, 16, 6, 1, 1, 1, 1, 1, 1, 1, 
1, 1, 1, 1, 1, 1, 1, 1 },
{ 1, 1, 1, 1, 1, 1, 1, 1, 1, 1, 1, 1, 3, 3, 3, 1, 
1, 3, 3, 1, 16, 16, 16, 6, 3, 3, 1, 1, 1, 1, 1, 1, 
1, 1, 1, 1, 1, 1, 1, 1 },
{ 1, 1, 1, 1, 1, 1, 1, 1, 1, 1, 1, 1, 1, 3, 3, 1, 
1, 3, 3, 3, 16, 16, 16, 1, 3, 3, 1, 1, 1, 1, 1, 1, 
1, 1, 1, 1, 1, 1, 1, 1 },
{ 1, 1, 1, 1, 1, 1, 1, 1, 1, 1, 1, 1, 1, 1, 1, 1, 
1, 1, 1, 3, 16, 16, 16, 1, 1, 1, 1, 1, 1, 1, 1, 1, 
1, 1, 1, 1, 1, 1, 1, 1 },
{ 1, 1, 1, 1, 1, 1, 1, 1, 1, 1, 1, 1, 1, 1, 1, 1, 
1, 1, 1, 1, 16, 16, 16, 1, 1, 1, 1, 3, 1, 1, 1, 1, 
1, 1, 1, 1, 1, 1, 1, 1 },
{ 1, 1, 1, 1, 1, 1, 1, 1, 1, 1, 1, 1, 1, 1, 1, 1, 
1, 1, 1, 1, 16, 16, 16, 1, 1, 1, 1, 1, 1, 3, 3, 1, 
1, 1, 1, 1, 1, 1, 1, 1 },
{ 1, 1, 1, 1, 1, 1, 1, 1, 1, 1, 1, 1, 1, 1, 3, 3, 
1, 1, 1, 1, 16, 16, 16, 1, 1, 1, 1, 1, 1, 1, 1, 1, 
1, 1, 1, 1, 1, 1, 1, 1 },
{ 1, 1, 1, 1, 1, 1, 1, 1, 1, 1, 1, 1, 1, 1, 3, 3, 
1, 1, 3, 3, 16, 16, 16, 1, 1, 1, 1, 1, 1, 1, 1, 1, 
3, 1, 1, 1, 1, 1, 1, 1 },
{ 1, 1, 1, 1, 1, 1, 1, 1, 1, 1, 1, 1, 1, 1, 1, 3, 
1, 1, 3, 15, 16, 16, 16, 1, 1, 1, 1, 1, 1, 1, 1, 1, 
1, 1, 1, 1, 1, 1, 1, 1 },
{ 1, 1, 1, 1, 1, 1, 1, 3, 3, 1, 1, 1, 1, 1, 1, 1, 
1, 1, 1, 16, 16, 16, 16, 1, 1, 1, 1, 1, 1, 1, 1, 1, 
1, 1, 1, 1, 3, 3, 1, 1 },
{ 1, 1, 1, 1, 1, 1, 1, 3, 3, 3, 1, 1, 1, 1, 1, 1, 
1, 1, 1, 16, 16, 16, 16, 1, 1, 1, 1, 1, 1, 1, 1, 1, 
1, 1, 1, 1, 3, 3, 3, 1 },
{ 1, 1, 1, 1, 1, 1, 1, 1, 3, 3, 1, 1, 1, 3, 0, 0, 
1, 2, 2, 2, 16, 16, 16, 1, 1, 1, 1, 1, 1, 1, 1, 1, 
1, 1, 1, 1, 1, 3, 3, 1 },
{ 1, 1, 1, 1, 1, 1, 1, 1, 1, 1, 1, 1, 0, 0, 0, 0, 
0, 2, 2, 2, 16, 16, 16, 1, 1, 1, 1, 1, 1, 1, 1, 3, 
3, 1, 1, 1, 1, 1, 1, 1 },
{ 1, 1, 3, 3, 1, 1, 1, 1, 1, 1, 1, 3, 0, 0, 0, 0, 
0, 2, 2, 2, 16, 16, 16, 1, 1, 1, 1, 1, 1, 1, 1, 3, 
3, 3, 1, 1, 1, 1, 1, 1 },
{ 1, 1, 3, 3, 3, 1, 1, 1, 1, 1, 1, 1, 1, 0, 0, 0, 
2, 2, 2, 2, 16, 16, 16, 1, 1, 1, 1, 1, 1, 1, 1, 1, 
3, 3, 1, 1, 3, 3, 1, 1 },
{ 1, 1, 1, 3, 3, 1, 1, 1, 1, 1, 1, 1, 1, 2, 2, 2, 
2, 2, 2, 16, 16, 16, 6, 1, 1, 1, 1, 1, 1, 1, 1, 1, 
1, 1, 1, 1, 3, 3, 3, 1 },
{ 1, 1, 1, 1, 1, 1, 1, 1, 1, 3, 1, 1, 1, 1, 2, 2, 
2, 16, 16, 16, 16, 6, 1, 1, 1, 1, 1, 1, 1, 1, 1, 1, 
1, 1, 1, 1, 1, 3, 3, 1 },
{ 1, 1, 1, 1, 1, 1, 1, 1, 1, 3, 3, 1, 1, 1, 2, 2, 
16, 16, 16, 16, 16, 1, 1, 1, 1, 1, 1, 3, 3, 1, 1, 1, 
1, 1, 1, 1, 1, 1, 1, 1 },
{ 1, 1, 1, 1, 3, 3, 1, 1, 1, 3, 3, 1, 1, 3, 1, 1, 
16, 16, 16, 16, 6, 1, 1, 1, 1, 1, 1, 1, 1, 1, 1, 1, 
1, 1, 1, 1, 1, 1, 1, 1 },
{ 1, 1, 1, 1, 3, 3, 3, 1, 1, 1, 1, 1, 1, 3, 1, 1, 
16, 16, 16, 16, 3, 1, 1, 1, 1, 1, 1, 1, 1, 1, 1, 1, 
1, 1, 3, 3, 3, 1, 1, 1 },
{ 1, 1, 1, 1, 1, 3, 3, 1, 1, 1, 1, 1, 3, 1, 1, 1, 
16, 16, 16, 16, 1, 1, 1, 1, 1, 3, 3, 1, 1, 1, 1, 1, 
1, 1, 1, 3, 3, 1, 1, 1 },
{ 1, 1, 1, 1, 1, 1, 1, 1, 1, 1, 1, 1, 1, 1, 1, 1, 
16, 16, 16, 17, 1, 1, 3, 1, 1, 3, 3, 3, 1, 1, 1, 3, 
1, 1, 1, 1, 1, 1, 1, 1 },
{ 1, 1, 1, 1, 1, 1, 1, 1, 3, 1, 1, 1, 1, 1, 1, 1, 
15, 16, 16, 17, 1, 1, 1, 1, 1, 1, 3, 3, 1, 1, 1, 1, 
1, 1, 1, 1, 1, 1, 3, 1 },
{ 1, 1, 1, 1, 1, 1, 3, 3, 3, 1, 1, 1, 1, 3, 3, 1, 
15, 16, 16, 17, 1, 1, 1, 1, 1, 1, 1, 1, 1, 1, 1, 1, 
1, 1, 1, 1, 1, 1, 1, 1 },
{ 1, 1, 1, 1, 1, 1, 1, 3, 3, 1, 1, 1, 1, 3, 3, 3, 
15, 16, 16, 17, 1, 1, 1, 1, 1, 1, 1, 1, 1, 3, 1, 1, 
1, 1, 1, 1, 1, 1, 1, 1 },
{ 1, 1, 1, 1, 1, 1, 1, 1, 1, 1, 1, 1, 1, 1, 1, 1, 
15, 16, 16, 17, 3, 3, 1, 1, 1, 1, 1, 1, 1, 1, 1, 1, 
1, 1, 1, 1, 1, 1, 1, 1 },
{ 1, 1, 1, 1, 1, 1, 1, 1, 1, 1, 1, 1, 1, 1, 1, 1, 
15, 16, 16, 17, 3, 1, 1, 1, 1, 1, 1, 1, 1, 1, 1, 1, 
1, 1, 1, 1, 1, 1, 1, 1 },
{ 1, 1, 1, 1, 1, 1, 1, 1, 1, 1, 1, 1, 1, 1, 3, 3, 
15, 16, 16, 17, 1, 1, 1, 1, 1, 1, 1, 1, 1, 1, 1, 1, 
1, 1, 1, 1, 1, 1, 1, 1 },
{ 1, 1, 1, 1, 1, 3, 3, 1, 1, 1, 1, 1, 1, 1, 3, 3, 
15, 16, 16, 17, 13, 1, 1, 1, 1, 1, 1, 1, 1, 1, 1, 1, 
1, 1, 1, 1, 1, 1, 1, 3 },
{ 0, 1, 1, 1, 1, 3, 3, 3, 1, 1, 1, 1, 1, 1, 1, 1, 
15, 16, 16, 16, 17, 1, 1, 1, 1, 1, 1, 1, 1, 1, 1, 1, 
1, 1, 1, 1, 1, 1, 1, 3 },
{ 0, 0, 1, 1, 1, 1, 3, 3, 1, 1, 1, 1, 1, 1, 1, 1, 
16, 16, 16, 16, 17, 1, 1, 1, 1, 1, 1, 1, 1, 1, 1, 1, 
1, 1, 1, 1, 1, 1, 1, 1 },
{ 0, 0, 1, 1, 1, 1, 1, 1, 1, 1, 1, 1, 1, 1, 1, 1, 
16, 16, 16, 16, 16, 13, 1, 1, 1, 3, 3, 3, 1, 1, 1, 1, 
1, 1, 1, 1, 1, 1, 1, 1 },
{ 0, 0, 0, 1, 1, 1, 1, 1, 1, 1, 1, 1, 3, 3, 1, 1, 
16, 16, 16, 16, 16, 16, 13, 1, 1, 1, 3, 3, 1, 1, 1, 1, 
1, 3, 3, 1, 1, 1, 1, 3 },
{ 0, 0, 0, 0, 1, 1, 3, 3, 1, 1, 1, 1, 3, 3, 3, 1, 
16, 16, 16, 16, 16, 16, 16, 13, 1, 1, 1, 1, 1, 1, 1, 1, 
1, 3, 3, 3, 1, 1, 1, 3 },
{ 0, 0, 0, 0, 1, 1, 3, 3, 3, 1, 1, 1, 1, 3, 3, 1, 
16, 16, 16, 16, 16, 16, 16, 16, 13, 1, 1, 1, 1, 3, 1, 1, 
1, 1, 1, 1, 1, 1, 1, 1 },
{ 0, 0, 0, 0, 1, 1, 1, 3, 3, 1, 1, 1, 1, 1, 1, 1, 
16, 16, 16, 16, 16, 16, 16, 16, 16, 13, 3, 3, 1, 1, 1, 1, 
1, 1, 1, 1, 1, 1, 1, 1 },
{ 0, 0, 0, 0, 1, 1, 1, 1, 1, 1, 1, 1, 1, 1, 1, 1, 
19, 16, 16, 16, 16, 16, 16, 16, 16, 16, 13, 1, 1, 1, 1, 1, 
1, 3, 3, 1, 1, 1, 1, 1 },
{ 0, 0, 0, 0, 1, 1, 1, 1, 1, 1, 3, 3, 1, 1, 3, 3, 
3, 16, 16, 16, 16, 16, 16, 16, 16, 16, 16, 13, 1, 3, 1, 1, 
1, 3, 3, 3, 1, 1, 1, 3 }
};

{
{ 0, 0, 0, 0, 0, 0, 0, 0, 0, 0, 0, 0, 0, 0, 0, 0, 
0, 0, 0, 0, 0, 0, 0, 0, 0, 0, 0, 0, 20, 21, 0, 0, 
0, 0, 0, 20, 21, 0, 0, 0 },
{ 0, 0, 0, 0, 0, 0, 0, 0, 0, 0, 0, 0, 0, 0, 0, 20, 
21, 0, 0, 0, 0, 0, 0, 0, 0, 0, 0, 0, 22, 23, 0, 0, 
0, 0, 0, 22, 23, 0, 0, 0 },
{ 0, 0, 0, 0, 0, 0, 0, 0, 0, 0, 0, 0, 0, 0, 0, 22, 
23, 37, 38, 0, 0, 0, 0, 0, 0, 0, 0, 0, 24, 25, 0, 0, 
0, 0, 0, 24, 25, 20, 21, 0 },
{ 0, 0, 0, 0, 0, 0, 0, 0, 20, 21, 0, 0, 37, 38, 0, 24, 
25, 39, 40, 0, 0, 0, 0, 0, 0, 0, 20, 21, 26, 27, 0, 0, 
20, 21, 0, 26, 27, 22, 23, 0 },
{ 0, 0, 0, 0, 0, 0, 0, 0, 22, 23, 0, 0, 39, 40, 0, 26, 
27, 41, 42, 0, 0, 0, 0, 0, 0, 0, 22, 23, 0, 0, 20, 21, 
22, 23, 0, 0, 0, 24, 25, 0 },
{ 0, 0, 0, 0, 0, 0, 0, 0, 24, 25, 0, 0, 41, 42, 0, 0, 
0, 20, 21, 0, 0, 0, 0, 0, 20, 21, 24, 25, 37, 38, 22, 23, 
24, 25, 0, 0, 0, 26, 27, 0 },
{ 0, 0, 0, 0, 0, 0, 0, 0, 26, 27, 0, 37, 38, 20, 21, 0, 
0, 22, 23, 0, 0, 0, 0, 0, 22, 23, 26, 27, 39, 40, 24, 25, 
26, 27, 0, 20, 21, 0, 0, 0 },
{ 0, 0, 0, 0, 0, 0, 0, 0, 0, 0, 0, 39, 40, 22, 23, 20, 
21, 24, 25, 0, 0, 0, 0, 0, 24, 25, 37, 38, 41, 42, 26, 27, 
0, 37, 38, 22, 23, 0, 0, 0 },
{ 0, 0, 0, 0, 0, 0, 0, 0, 0, 0, 0, 41, 42, 24, 25, 22, 
23, 26, 27, 0, 0, 0, 0, 0, 26, 27, 39, 40, 0, 20, 21, 0, 
0, 39, 40, 24, 25, 0, 0, 0 },
{ 0, 0, 0, 0, 0, 0, 0, 0, 0, 0, 20, 21, 0, 26, 27, 24, 
25, 0, 0, 0, 0, 0, 0, 0, 0, 0, 41, 42, 0, 22, 23, 0, 
0, 41, 42, 26, 27, 20, 21, 0 },
{ 0, 0, 0, 0, 0, 0, 0, 0, 0, 0, 22, 23, 0, 0, 0, 26, 
27, 0, 0, 0, 0, 0, 0, 0, 0, 0, 0, 37, 38, 24, 25, 0, 
0, 0, 0, 0, 0, 22, 23, 0 },
{ 0, 0, 0, 0, 0, 0, 0, 0, 37, 38, 24, 25, 0, 0, 0, 0, 
0, 0, 0, 0, 0, 0, 0, 0, 37, 38, 0, 39, 40, 26, 27, 0, 
0, 0, 0, 0, 0, 24, 25, 0 },
{ 0, 0, 0, 0, 0, 0, 0, 0, 39, 40, 26, 27, 0, 0, 0, 0, 
0, 0, 0, 0, 0, 0, 0, 0, 39, 40, 0, 41, 42, 0, 0, 0, 
0, 37, 38, 0, 0, 26, 27, 0 },
{ 0, 0, 0, 0, 0, 0, 0, 0, 41, 42, 0, 0, 0, 0, 0, 0, 
0, 0, 0, 0, 0, 0, 0, 0, 41, 42, 0, 37, 38, 20, 21, 0, 
0, 39, 40, 0, 0, 0, 0, 0 },
{ 0, 0, 0, 0, 0, 0, 0, 0, 0, 0, 0, 0, 0, 0, 0, 0, 
0, 0, 0, 0, 0, 0, 0, 0, 0, 0, 0, 39, 40, 22, 23, 0, 
0, 41, 42, 0, 0, 37, 38, 0 },
{ 0, 0, 0, 0, 0, 0, 0, 37, 38, 0, 0, 0, 0, 0, 0, 0, 
0, 0, 0, 0, 0, 0, 0, 0, 0, 20, 21, 41, 42, 24, 25, 0, 
0, 0, 0, 0, 0, 39, 40, 0 },
{ 0, 0, 0, 0, 0, 0, 0, 39, 40, 0, 0, 0, 0, 0, 0, 0, 
0, 0, 0, 0, 0, 0, 0, 20, 21, 22, 23, 0, 0, 26, 27, 37, 
38, 0, 37, 38, 0, 41, 42, 0 },
{ 0, 0, 0, 0, 0, 0, 0, 41, 42, 0, 0, 20, 21, 0, 0, 0, 
0, 0, 0, 0, 0, 0, 0, 22, 23, 24, 25, 0, 20, 21, 0, 39, 
40, 0, 39, 40, 0, 0, 0, 0 },
{ 0, 0, 0, 0, 0, 0, 0, 0, 0, 0, 0, 22, 23, 0, 0, 0, 
0, 0, 0, 0, 0, 0, 0, 24, 25, 26, 27, 0, 22, 23, 0, 41, 
42, 0, 41, 42, 37, 38, 0, 0 },
{ 0, 0, 0, 0, 0, 0, 0, 0, 0, 37, 38, 24, 25, 0, 0, 0, 
0, 0, 0, 0, 0, 20, 21, 26, 27, 0, 0, 0, 24, 25, 0, 0, 
37, 38, 0, 0, 39, 40, 0, 0 },
{ 0, 0, 0, 0, 0, 0, 0, 37, 38, 39, 40, 26, 27, 0, 0, 0, 
0, 0, 0, 0, 0, 22, 23, 0, 0, 37, 38, 0, 26, 27, 0, 0, 
39, 40, 0, 0, 41, 42, 0, 0 },
{ 0, 0, 0, 0, 0, 0, 0, 39, 40, 41, 42, 0, 20, 21, 0, 0, 
0, 0, 0, 0, 0, 24, 25, 37, 38, 39, 40, 20, 21, 0, 37, 38, 
41, 42, 0, 0, 0, 0, 0, 0 },
{ 0, 0, 0, 0, 0, 0, 0, 41, 42, 0, 37, 38, 22, 23, 0, 0, 
0, 0, 0, 0, 0, 26, 27, 39, 40, 41, 42, 22, 23, 0, 39, 40, 
0, 0, 37, 38, 0, 0, 0, 0 },
{ 0, 0, 0, 0, 0, 0, 0, 0, 37, 38, 39, 40, 24, 25, 37, 38, 
0, 0, 0, 0, 20, 21, 0, 41, 42, 20, 21, 24, 25, 0, 41, 42, 
0, 0, 39, 40, 0, 0, 0, 0 },
{ 0, 0, 0, 0, 0, 0, 0, 0, 39, 40, 41, 42, 26, 27, 39, 40, 
0, 0, 0, 0, 22, 23, 20, 21, 0, 22, 23, 26, 27, 0, 0, 37, 
38, 0, 41, 42, 0, 0, 0, 0 },
{ 0, 0, 0, 0, 0, 0, 0, 0, 41, 42, 0, 37, 38, 0, 41, 42, 
0, 0, 0, 0, 24, 25, 22, 23, 0, 24, 25, 0, 0, 0, 0, 39, 
40, 0, 0, 0, 37, 38, 0, 0 },
{ 0, 0, 0, 0, 0, 0, 0, 0, 0, 0, 0, 39, 40, 37, 38, 0, 
0, 0, 0, 0, 26, 27, 24, 25, 0, 26, 27, 0, 0, 37, 38, 41, 
42, 0, 37, 38, 39, 40, 0, 0 },
{ 0, 0, 0, 0, 0, 0, 0, 0, 0, 0, 0, 41, 42, 39, 40, 0, 
0, 0, 0, 0, 0, 0, 26, 27, 0, 0, 0, 0, 0, 39, 40, 0, 
37, 38, 39, 40, 41, 42, 0, 0 },
{ 0, 0, 0, 0, 0, 0, 0, 0, 0, 0, 0, 0, 0, 41, 42, 0, 
0, 0, 0, 0, 0, 0, 0, 0, 0, 0, 0, 0, 0, 41, 42, 0, 
39, 40, 41, 42, 0, 0, 0, 0 },
{ 0, 0, 0, 0, 0, 0, 0, 0, 0, 20, 21, 0, 0, 0, 0, 0, 
0, 0, 0, 0, 0, 0, 0, 0, 0, 0, 0, 20, 21, 0, 0, 0, 
41, 42, 0, 0, 0, 0, 0, 0 },
{ 0, 0, 0, 0, 0, 0, 0, 0, 0, 22, 23, 37, 38, 0, 0, 0, 
0, 0, 0, 0, 0, 0, 0, 20, 21, 0, 0, 22, 23, 0, 20, 21, 
37, 38, 37, 38, 0, 0, 0, 0 },
{ 0, 0, 0, 0, 0, 0, 0, 0, 0, 24, 25, 39, 40, 37, 38, 0, 
0, 0, 0, 0, 0, 0, 0, 22, 23, 20, 21, 24, 25, 0, 22, 23, 
39, 40, 39, 40, 0, 0, 0, 0 },
{ 0, 0, 0, 0, 0, 0, 0, 0, 0, 26, 27, 41, 42, 39, 40, 0, 
0, 0, 0, 0, 0, 0, 0, 24, 25, 22, 23, 26, 27, 0, 24, 25, 
41, 42, 41, 42, 0, 37, 38, 0 },
{ 0, 0, 0, 0, 0, 0, 0, 0, 0, 0, 20, 21, 0, 41, 42, 0, 
0, 0, 0, 0, 0, 0, 0, 26, 27, 24, 25, 0, 0, 0, 26, 27, 
0, 0, 0, 20, 21, 39, 40, 0 },
{ 0, 0, 0, 0, 0, 0, 0, 0, 0, 0, 22, 23, 20, 21, 0, 0, 
0, 0, 0, 0, 0, 0, 0, 0, 0, 26, 27, 0, 0, 20, 21, 0, 
0, 20, 21, 22, 23, 41, 42, 0 },
{ 0, 0, 0, 0, 0, 0, 0, 0, 0, 0, 24, 25, 22, 23, 0, 0, 
0, 0, 0, 0, 0, 0, 0, 0, 0, 0, 0, 20, 21, 22, 23, 0, 
0, 22, 23, 24, 25, 20, 21, 0 },
{ 0, 0, 0, 0, 0, 0, 0, 0, 0, 0, 26, 27, 24, 25, 0, 0, 
0, 0, 0, 0, 0, 0, 0, 0, 0, 0, 0, 22, 23, 24, 25, 20, 
21, 24, 25, 26, 27, 22, 23, 0 },
{ 0, 0, 0, 0, 0, 0, 0, 0, 0, 0, 0, 0, 26, 27, 0, 0, 
0, 0, 0, 0, 0, 0, 0, 0, 0, 0, 0, 24, 25, 26, 27, 22, 
23, 26, 27, 0, 0, 24, 25, 0 },
{ 0, 0, 0, 0, 0, 0, 0, 0, 0, 0, 0, 0, 0, 0, 0, 0, 
0, 0, 0, 0, 0, 0, 0, 0, 0, 0, 0, 26, 27, 0, 0, 24, 
25, 0, 0, 0, 0, 26, 27, 0 },
{ 0, 0, 0, 0, 0, 0, 0, 0, 0, 0, 0, 0, 0, 0, 0, 0, 
0, 0, 0, 0, 0, 0, 0, 0, 0, 0, 0, 0, 0, 0, 0, 26, 
27, 0, 0, 0, 0, 0, 0, 0 }
}

