{
{ 0, 0, 0, 0, 0, 0, 0, 0, 0, 0, 0, 0, 0, 0, 0, 0, 
0, 0, 0, 0, 0, 0, 0, 0, 0, 0, 0, 0, 0, 0, 0, 0, 
0, 0, 0, 0, 0, 0, 0, 0 },
{ 0, 0, 0, 0, 0, 0, 0, 0, 0, 0, 0, 0, 0, 0, 0, 0, 
0, 0, 0, 0, 0, 0, 0, 0, 0, 0, 0, 0, 0, 0, 0, 0, 
0, 0, 0, 0, 0, 0, 0, 0 },
{ 0, 0, 0, 0, 0, 0, 0, 0, 0, 0, 0, 0, 0, 0, 0, 0, 
0, 0, 0, 0, 0, 0, 0, 0, 0, 0, 0, 0, 0, 0, 0, 0, 
0, 0, 0, 0, 0, 0, 0, 0 },
{ 0, 0, 0, 0, 0, 0, 0, 0, 0, 0, 0, 0, 0, 0, 0, 0, 
0, 0, 0, 0, 0, 0, 0, 0, 0, 0, 0, 0, 0, 0, 0, 0, 
0, 0, 0, 0, 0, 0, 0, 0 },
{ 0, 0, 0, 0, 0, 0, 0, 0, 0, 0, 0, 0, 0, 0, 0, 0, 
0, 0, 0, 0, 0, 0, 0, 0, 0, 0, 0, 0, 0, 0, 0, 0, 
0, 0, 0, 0, 0, 0, 0, 0 },
{ 0, 0, 0, 0, 0, 0, 0, 0, 0, 0, 0, 0, 0, 0, 0, 0, 
0, 0, 0, 0, 0, 0, 0, 0, 0, 0, 0, 0, 0, 0, 0, 0, 
0, 0, 0, 0, 0, 0, 0, 0 },
{ 0, 0, 0, 0, 0, 0, 0, 0, 0, 0, 0, 0, 0, 0, 0, 0, 
0, 0, 0, 0, 0, 0, 0, 0, 0, 0, 0, 0, 0, 0, 0, 0, 
0, 0, 0, 0, 0, 0, 0, 0 },
{ 0, 0, 0, 0, 0, 0, 0, 0, 0, 0, 0, 0, 0, 0, 0, 0, 
0, 0, 0, 0, 0, 0, 0, 0, 0, 0, 0, 0, 0, 0, 0, 0, 
0, 0, 0, 0, 0, 0, 0, 0 },
{ 0, 0, 0, 0, 0, 0, 0, 0, 0, 0, 0, 0, 0, 0, 0, 0, 
0, 0, 0, 0, 0, 0, 0, 0, 0, 0, 0, 0, 0, 0, 0, 0, 
0, 0, 0, 0, 0, 0, 0, 0 },
{ 0, 0, 0, 0, 0, 0, 0, 0, 0, 0, 0, 0, 0, 0, 0, 0, 
0, 0, 0, 0, 0, 0, 0, 0, 0, 0, 0, 0, 0, 0, 0, 0, 
0, 0, 0, 0, 0, 0, 2, 1 },
{ 0, 0, 0, 0, 0, 0, 0, 0, 0, 0, 0, 0, 0, 0, 0, 0, 
0, 0, 0, 0, 0, 0, 0, 0, 0, 0, 0, 0, 0, 0, 0, 0, 
0, 0, 0, 0, 0, 2, 1, 2 },
{ 0, 0, 0, 0, 0, 0, 0, 0, 0, 0, 0, 0, 0, 0, 0, 0, 
0, 0, 0, 0, 0, 0, 0, 0, 0, 0, 0, 0, 0, 0, 0, 0, 
0, 0, 0, 0, 2, 1, 2, 1 },
{ 0, 0, 0, 0, 0, 0, 0, 0, 0, 0, 0, 0, 0, 0, 0, 0, 
0, 0, 0, 0, 0, 0, 0, 0, 0, 0, 0, 0, 0, 0, 0, 0, 
0, 0, 0, 2, 1, 2, 1, 2 },
{ 0, 0, 0, 0, 0, 0, 0, 0, 0, 0, 0, 0, 0, 0, 0, 0, 
0, 0, 0, 0, 0, 0, 0, 0, 0, 0, 0, 0, 0, 0, 0, 0, 
0, 0, 0, 1, 2, 1, 2, 1 },
{ 0, 0, 0, 0, 0, 0, 0, 0, 0, 0, 0, 0, 0, 0, 0, 0, 
0, 0, 0, 0, 0, 0, 0, 0, 0, 0, 0, 0, 0, 0, 0, 0, 
0, 0, 0, 2, 1, 2, 1, 2 },
{ 0, 0, 0, 0, 0, 0, 0, 0, 0, 0, 0, 0, 0, 0, 0, 0, 
0, 0, 0, 0, 0, 0, 0, 0, 0, 0, 0, 0, 0, 0, 0, 0, 
0, 0, 0, 1, 2, 1, 2, 1 },
{ 0, 0, 0, 0, 0, 0, 0, 0, 0, 0, 0, 0, 0, 0, 0, 0, 
0, 0, 0, 0, 0, 0, 0, 0, 0, 0, 0, 0, 0, 0, 0, 0, 
0, 0, 0, 0, 0, 0, 0, 0 },
{ 0, 0, 0, 0, 0, 0, 0, 0, 0, 0, 0, 0, 0, 0, 0, 0, 
0, 0, 0, 0, 0, 0, 0, 0, 0, 0, 0, 0, 0, 0, 0, 0, 
0, 0, 0, 0, 0, 0, 0, 0 },
{ 0, 0, 0, 0, 0, 0, 0, 0, 0, 0, 0, 0, 0, 0, 0, 0, 
0, 0, 0, 0, 0, 0, 0, 0, 0, 0, 0, 0, 0, 0, 0, 0, 
0, 0, 0, 0, 0, 0, 0, 0 },
{ 0, 0, 0, 0, 0, 0, 0, 0, 0, 0, 0, 0, 0, 0, 0, 0, 
0, 0, 0, 0, 0, 0, 0, 0, 0, 0, 0, 0, 0, 0, 0, 0, 
0, 0, 0, 0, 0, 0, 0, 0 },
{ 0, 0, 0, 0, 0, 0, 0, 0, 0, 0, 0, 0, 0, 0, 0, 0, 
0, 0, 0, 0, 0, 0, 0, 0, 0, 0, 0, 0, 0, 0, 0, 0, 
0, 0, 0, 0, 0, 0, 0, 0 },
{ 0, 0, 0, 0, 0, 0, 0, 0, 0, 0, 0, 0, 0, 0, 0, 0, 
0, 0, 0, 0, 0, 0, 0, 0, 0, 0, 0, 0, 0, 0, 0, 0, 
0, 0, 0, 0, 0, 0, 0, 0 },
{ 0, 0, 0, 0, 0, 0, 0, 0, 0, 0, 0, 0, 0, 0, 0, 0, 
0, 0, 0, 0, 0, 0, 0, 0, 0, 0, 0, 0, 0, 0, 0, 0, 
0, 0, 0, 0, 0, 0, 0, 0 },
{ 0, 0, 0, 0, 0, 0, 0, 0, 0, 0, 0, 0, 0, 0, 0, 0, 
0, 0, 0, 0, 0, 0, 0, 0, 0, 0, 0, 0, 0, 0, 0, 0, 
0, 0, 0, 0, 0, 0, 0, 0 },
{ 0, 0, 0, 0, 0, 0, 0, 0, 0, 0, 0, 0, 0, 0, 0, 0, 
0, 0, 0, 0, 0, 0, 0, 0, 0, 0, 0, 0, 0, 0, 0, 0, 
0, 0, 0, 0, 0, 0, 0, 0 },
{ 0, 0, 0, 0, 0, 0, 0, 0, 0, 0, 0, 0, 0, 0, 0, 0, 
0, 0, 0, 0, 0, 0, 0, 0, 0, 0, 0, 0, 0, 0, 0, 0, 
0, 0, 0, 0, 0, 0, 0, 0 },
{ 0, 0, 0, 0, 0, 0, 0, 0, 0, 0, 0, 0, 0, 0, 0, 0, 
0, 0, 0, 0, 0, 0, 0, 0, 0, 0, 0, 0, 0, 0, 0, 0, 
0, 0, 0, 0, 0, 0, 0, 0 },
{ 0, 0, 0, 0, 0, 0, 0, 0, 0, 0, 0, 0, 0, 0, 0, 0, 
0, 0, 0, 0, 0, 0, 0, 0, 0, 0, 0, 0, 0, 0, 0, 0, 
0, 0, 0, 0, 0, 0, 0, 0 },
{ 0, 0, 0, 0, 0, 0, 0, 0, 0, 0, 0, 2, 1, 2, 0, 0, 
0, 0, 0, 0, 0, 0, 0, 0, 0, 0, 0, 0, 0, 0, 0, 0, 
0, 0, 0, 0, 0, 0, 0, 0 },
{ 0, 0, 0, 0, 0, 0, 0, 0, 0, 0, 0, 1, 2, 1, 2, 0, 
0, 0, 0, 0, 0, 0, 0, 0, 0, 0, 0, 0, 0, 0, 0, 0, 
0, 0, 0, 0, 0, 0, 0, 0 },
{ 0, 0, 0, 0, 0, 0, 0, 0, 0, 0, 0, 2, 1, 2, 1, 2, 
1, 0, 0, 0, 0, 0, 0, 0, 0, 0, 0, 0, 0, 0, 0, 0, 
0, 0, 0, 0, 0, 0, 0, 0 },
{ 0, 0, 0, 0, 0, 0, 0, 0, 0, 0, 0, 1, 2, 1, 2, 2, 
1, 2, 0, 0, 0, 0, 0, 0, 0, 0, 0, 0, 0, 0, 0, 0, 
0, 0, 0, 0, 0, 0, 0, 0 },
{ 0, 0, 0, 0, 0, 0, 0, 0, 0, 0, 0, 2, 1, 2, 1, 1, 
2, 1, 1, 2, 0, 0, 0, 0, 0, 0, 0, 0, 0, 0, 0, 0, 
0, 0, 0, 0, 0, 0, 0, 0 },
{ 0, 0, 0, 0, 0, 0, 0, 0, 0, 0, 0, 2, 2, 1, 2, 2, 
1, 2, 2, 1, 2, 1, 2, 0, 0, 0, 0, 0, 0, 0, 0, 0, 
0, 0, 0, 0, 0, 0, 0, 0 },
{ 0, 0, 0, 0, 0, 0, 0, 0, 0, 0, 0, 1, 1, 2, 1, 1, 
1, 2, 1, 2, 1, 2, 2, 1, 2, 0, 0, 0, 0, 0, 0, 0, 
0, 0, 0, 0, 0, 0, 0, 0 },
{ 0, 0, 0, 0, 0, 0, 0, 0, 0, 0, 0, 2, 2, 1, 2, 2, 
2, 1, 2, 2, 1, 2, 1, 2, 1, 2, 1, 2, 0, 0, 0, 0, 
0, 0, 0, 0, 0, 0, 0, 0 },
{ 0, 0, 0, 0, 0, 0, 0, 0, 0, 0, 0, 2, 1, 2, 1, 2, 
1, 2, 1, 1, 2, 1, 2, 1, 2, 1, 2, 1, 0, 0, 0, 0, 
0, 0, 0, 0, 0, 0, 0, 0 },
{ 0, 0, 0, 0, 0, 0, 0, 0, 0, 0, 0, 1, 2, 1, 2, 1, 
2, 1, 2, 2, 1, 2, 1, 2, 2, 2, 2, 1, 2, 0, 0, 0, 
0, 0, 0, 0, 0, 0, 0, 0 },
{ 0, 0, 0, 0, 0, 0, 0, 0, 0, 0, 0, 2, 1, 2, 1, 2, 
1, 2, 1, 2, 1, 2, 2, 1, 1, 2, 1, 2, 1, 0, 0, 0, 
0, 0, 0, 0, 0, 0, 0, 0 },
{ 0, 0, 0, 0, 0, 0, 0, 0, 0, 0, 0, 2, 1, 2, 2, 1, 
2, 1, 2, 1, 2, 1, 2, 2, 1, 2, 2, 1, 2, 0, 0, 0, 
0, 0, 0, 0, 0, 0, 0, 0 }
};
{
{ 78, 78, 78, 78, 78, 78, 78, 78, 78, 78, 78, 78, 78, 78, 79, 78, 
78, 78, 78, 78, 78, 78, 78, 78, 78, 78, 78, 78, 78, 78, 78, 78, 
78, 79, 79, 79, 79, 79, 79, 79 },
{ 78, 78, 78, 78, 79, 78, 78, 78, 78, 79, 78, 78, 78, 78, 78, 78, 
78, 78, 79, 78, 78, 78, 78, 79, 78, 78, 78, 78, 79, 78, 78, 78, 
78, 79, 79, 79, 79, 79, 79, 79 },
{ 79, 78, 79, 78, 78, 79, 78, 79, 78, 78, 79, 78, 79, 78, 79, 78, 
79, 78, 78, 79, 78, 79, 78, 78, 79, 78, 79, 78, 78, 79, 78, 79, 
78, 78, 79, 79, 79, 79, 79, 79 },
{ 79, 78, 78, 78, 79, 79, 78, 78, 78, 79, 79, 78, 78, 78, 79, 78, 
78, 78, 79, 79, 78, 78, 78, 79, 79, 78, 78, 78, 79, 79, 78, 78, 
78, 79, 78, 78, 78, 78, 78, 78 },
{ 78, 78, 79, 78, 78, 78, 78, 79, 78, 78, 78, 78, 79, 78, 79, 78, 
79, 78, 78, 78, 78, 79, 78, 78, 78, 78, 79, 78, 78, 78, 78, 79, 
78, 78, 78, 78, 78, 78, 44, 0 },
{ 78, 78, 78, 78, 78, 78, 78, 78, 78, 78, 78, 78, 78, 78, 78, 78, 
78, 78, 78, 78, 78, 78, 78, 78, 79, 78, 78, 79, 78, 78, 78, 78, 
78, 78, 78, 78, 78, 44, 0, 0 },
{ 78, 78, 78, 78, 78, 78, 78, 78, 78, 78, 78, 78, 78, 78, 78, 78, 
78, 78, 78, 78, 78, 78, 78, 78, 78, 79, 78, 78, 78, 78, 78, 78, 
78, 78, 78, 78, 44, 0, 0, 0 },
{ 78, 78, 78, 78, 78, 78, 78, 78, 78, 78, 78, 78, 78, 78, 78, 78, 
78, 78, 78, 78, 78, 79, 78, 78, 78, 78, 78, 78, 78, 78, 78, 78, 
78, 78, 78, 50, 0, 0, 58, 78 },
{ 78, 78, 78, 78, 78, 78, 78, 78, 78, 78, 78, 78, 78, 78, 78, 78, 
78, 78, 78, 78, 78, 78, 78, 79, 78, 78, 78, 78, 79, 78, 78, 78, 
78, 78, 0, 0, 0, 58, 60, 78 },
{ 78, 78, 78, 78, 78, 78, 0, 0, 0, 0, 0, 0, 0, 0, 0, 0, 
0, 0, 78, 78, 78, 78, 78, 78, 78, 78, 78, 78, 78, 78, 78, 0, 
0, 0, 0, 0, 0, 60, 0, 0 },
{ 78, 78, 78, 78, 78, 78, 0, 0, 0, 0, 0, 0, 0, 0, 0, 0, 
0, 0, 0, 78, 78, 78, 78, 78, 78, 78, 78, 78, 78, 78, 78, 0, 
0, 0, 0, 0, 0, 0, 0, 0 },
{ 78, 78, 78, 80, 78, 78, 0, 0, 0, 0, 0, 0, 0, 0, 0, 0, 
0, 0, 0, 0, 78, 78, 78, 78, 78, 78, 78, 78, 78, 78, 78, 0, 
0, 0, 0, 0, 0, 0, 0, 0 },
{ 78, 78, 78, 78, 78, 78, 0, 0, 0, 0, 0, 0, 0, 0, 0, 0, 
0, 0, 0, 0, 0, 78, 78, 78, 78, 78, 78, 78, 78, 78, 78, 0, 
0, 0, 0, 0, 0, 0, 0, 0 },
{ 78, 78, 78, 78, 78, 78, 0, 0, 0, 0, 0, 0, 0, 0, 0, 0, 
0, 0, 0, 0, 0, 0, 78, 78, 38, 71, 71, 37, 78, 78, 38, 71, 
71, 37, 78, 0, 0, 0, 0, 0 },
{ 78, 78, 78, 38, 71, 71, 73, 93, 93, 11, 11, 93, 19, 19, 19, 19, 
19, 19, 70, 71, 37, 0, 78, 78, 77, 93, 93, 93, 19, 19, 19, 93, 
93, 74, 78, 0, 0, 0, 0, 0 },
{ 78, 78, 78, 64, 93, 93, 11, 11, 3, 93, 11, 11, 20, 20, 20, 20, 
20, 20, 3, 93, 59, 0, 78, 78, 64, 93, 93, 93, 20, 20, 20, 93, 
93, 74, 78, 0, 0, 0, 0, 0 },
{ 78, 78, 78, 64, 93, 93, 11, 93, 3, 11, 3, 93, 21, 21, 21, 21, 
21, 21, 93, 3, 59, 0, 78, 78, 10, 93, 93, 93, 21, 21, 21, 93, 
93, 74, 78, 78, 78, 78, 78, 78 },
{ 78, 78, 78, 64, 93, 93, 66, 67, 67, 67, 67, 9, 0, 0, 0, 0, 
0, 0, 69, 93, 59, 0, 0, 0, 0, 13, 14, 15, 0, 0, 64, 93, 
93, 74, 78, 78, 78, 78, 78, 78 },
{ 78, 78, 78, 64, 93, 93, 74, 78, 78, 80, 78, 79, 78, 78, 78, 78, 
78, 0, 64, 93, 59, 0, 0, 0, 0, 16, 17, 18, 0, 0, 64, 93, 
93, 70, 71, 72, 71, 72, 71, 72 },
{ 78, 78, 78, 64, 93, 93, 74, 79, 78, 79, 78, 78, 78, 80, 78, 76, 
79, 0, 64, 3, 59, 0, 0, 0, 0, 16, 17, 18, 0, 0, 64, 93, 
93, 93, 93, 93, 93, 93, 93, 93 },
{ 78, 78, 78, 64, 93, 93, 74, 79, 76, 78, 78, 80, 79, 76, 79, 76, 
78, 0, 64, 3, 59, 0, 0, 0, 0, 16, 17, 18, 0, 0, 10, 69, 
93, 93, 93, 93, 93, 93, 93, 93 },
{ 78, 78, 78, 64, 93, 93, 74, 78, 78, 79, 78, 78, 79, 78, 78, 78, 
79, 0, 64, 93, 70, 71, 71, 71, 73, 93, 93, 66, 78, 0, 0, 10, 
67, 68, 67, 68, 67, 68, 67, 68 },
{ 78, 78, 78, 64, 93, 93, 70, 37, 78, 78, 78, 78, 78, 78, 40, 78, 
78, 0, 64, 11, 93, 3, 93, 93, 93, 93, 93, 74, 78, 78, 0, 0, 
0, 78, 78, 78, 78, 78, 78, 78 },
{ 78, 78, 78, 64, 93, 93, 93, 70, 37, 76, 78, 78, 40, 79, 76, 78, 
78, 0, 10, 68, 67, 68, 67, 68, 67, 68, 67, 9, 78, 78, 78, 0, 
0, 0, 78, 78, 78, 78, 78, 78 },
{ 78, 78, 78, 10, 69, 93, 93, 93, 74, 78, 78, 78, 80, 78, 79, 40, 
78, 0, 0, 0, 0, 0, 0, 0, 0, 0, 0, 0, 0, 78, 78, 78, 
0, 0, 0, 0, 0, 0, 0, 0 },
{ 79, 79, 79, 79, 10, 69, 93, 93, 74, 78, 78, 76, 78, 78, 76, 78, 
78, 0, 0, 0, 0, 0, 0, 0, 0, 0, 0, 0, 0, 0, 0, 0, 
0, 0, 0, 0, 0, 0, 0, 0 },
{ 79, 78, 79, 78, 78, 64, 93, 93, 74, 78, 76, 78, 79, 78, 79, 78, 
78, 79, 78, 79, 78, 78, 79, 40, 79, 78, 78, 79, 79, 79, 79, 79, 
79, 79, 79, 79, 78, 79, 78, 78 },
{ 79, 78, 78, 40, 79, 64, 93, 93, 74, 78, 78, 80, 79, 76, 78, 78, 
79, 79, 78, 78, 78, 79, 79, 78, 78, 78, 79, 79, 79, 79, 79, 79, 
79, 79, 79, 79, 78, 78, 78, 79 },
{ 78, 78, 79, 78, 78, 64, 93, 93, 74, 78, 78, 0, 0, 0, 79, 40, 
78, 78, 78, 79, 78, 78, 40, 78, 79, 78, 78, 78, 78, 78, 78, 78, 
78, 78, 78, 78, 78, 79, 78, 78 },
{ 78, 79, 78, 78, 78, 64, 93, 93, 74, 78, 78, 0, 0, 0, 0, 78, 
78, 78, 79, 78, 40, 78, 78, 40, 78, 40, 78, 78, 78, 78, 78, 78, 
78, 78, 78, 78, 79, 78, 78, 78 },
{ 78, 78, 79, 78, 78, 64, 93, 93, 74, 78, 78, 0, 0, 0, 0, 0, 
0, 78, 78, 79, 78, 78, 78, 78, 79, 78, 78, 78, 78, 78, 78, 78, 
78, 78, 78, 78, 78, 79, 78, 78 },
{ 78, 78, 78, 78, 78, 64, 93, 93, 74, 78, 78, 0, 0, 0, 0, 0, 
0, 0, 78, 78, 78, 78, 78, 78, 78, 78, 78, 78, 78, 78, 78, 78, 
78, 78, 78, 78, 78, 78, 78, 78 },
{ 78, 79, 78, 78, 78, 64, 4, 93, 74, 79, 78, 0, 0, 0, 0, 0, 
0, 0, 0, 0, 79, 78, 78, 79, 79, 79, 79, 79, 79, 79, 78, 79, 
78, 79, 78, 79, 78, 78, 79, 79 },
{ 78, 78, 79, 78, 78, 64, 4, 93, 74, 79, 78, 0, 0, 0, 0, 0, 
0, 0, 0, 0, 0, 0, 0, 79, 79, 79, 79, 79, 79, 79, 78, 78, 
78, 79, 78, 78, 78, 79, 79, 79 },
{ 78, 78, 78, 78, 78, 64, 93, 3, 74, 78, 78, 0, 0, 0, 0, 0, 
0, 0, 0, 0, 0, 0, 0, 0, 0, 78, 78, 78, 78, 78, 78, 79, 
78, 78, 78, 79, 78, 78, 79, 79 },
{ 78, 78, 79, 78, 78, 64, 11, 93, 74, 78, 79, 0, 0, 0, 0, 0, 
0, 0, 0, 0, 0, 0, 0, 0, 0, 0, 0, 0, 78, 78, 79, 78, 
78, 78, 79, 78, 78, 78, 79, 79 },
{ 78, 79, 78, 78, 78, 64, 93, 11, 74, 78, 78, 0, 0, 0, 0, 0, 
0, 0, 0, 0, 0, 0, 0, 0, 0, 0, 0, 0, 78, 78, 78, 79, 
78, 78, 78, 79, 78, 78, 79, 79 },
{ 78, 78, 79, 78, 78, 64, 3, 11, 74, 78, 78, 0, 0, 0, 0, 0, 
0, 0, 0, 0, 0, 0, 0, 0, 0, 0, 0, 0, 0, 78, 78, 78, 
78, 78, 78, 78, 78, 78, 79, 79 },
{ 78, 78, 78, 78, 78, 64, 93, 93, 74, 79, 78, 0, 0, 0, 0, 0, 
0, 0, 0, 0, 0, 0, 0, 0, 0, 0, 0, 0, 0, 79, 78, 79, 
78, 78, 79, 78, 79, 78, 79, 79 },
{ 79, 79, 79, 79, 79, 64, 11, 93, 74, 79, 78, 0, 0, 0, 0, 0, 
0, 0, 0, 0, 0, 0, 0, 0, 0, 0, 0, 0, 0, 79, 78, 78, 
78, 79, 79, 78, 78, 78, 79, 79 }
};
{
{ 0, 0, 0, 0, 0, 0, 0, 0, 0, 0, 0, 0, 0, 0, 0, 0, 
0, 0, 0, 0, 0, 0, 0, 0, 0, 0, 0, 0, 0, 0, 0, 0, 
0, 0, 0, 0, 0, 0, 0, 0 },
{ 0, 0, 0, 0, 0, 0, 0, 0, 0, 0, 0, 0, 0, 0, 0, 0, 
0, 0, 0, 0, 0, 0, 0, 0, 0, 0, 0, 0, 0, 0, 0, 0, 
0, 0, 0, 0, 0, 0, 0, 0 },
{ 0, 0, 0, 0, 0, 0, 0, 0, 0, 0, 0, 0, 0, 0, 0, 0, 
0, 0, 0, 0, 0, 0, 0, 0, 0, 0, 0, 0, 0, 0, 0, 0, 
0, 0, 0, 0, 0, 0, 0, 0 },
{ 0, 0, 0, 0, 0, 0, 0, 0, 0, 0, 0, 0, 0, 0, 0, 0, 
0, 0, 0, 0, 0, 0, 0, 0, 0, 0, 0, 0, 0, 0, 0, 0, 
0, 0, 0, 0, 0, 0, 0, 0 },
{ 0, 0, 0, 0, 0, 0, 0, 0, 0, 0, 0, 0, 0, 0, 0, 0, 
0, 0, 0, 0, 0, 0, 0, 0, 0, 0, 0, 0, 0, 0, 0, 0, 
0, 0, 0, 0, 0, 0, 44, 45 },
{ 0, 0, 0, 0, 0, 0, 0, 0, 0, 0, 0, 0, 0, 0, 0, 0, 
0, 0, 0, 0, 0, 0, 0, 0, 0, 0, 0, 0, 0, 0, 0, 0, 
0, 0, 0, 0, 0, 44, 53, 54 },
{ 0, 0, 0, 0, 0, 0, 0, 0, 0, 0, 0, 0, 0, 0, 0, 0, 
0, 0, 0, 0, 0, 0, 0, 0, 0, 0, 0, 0, 0, 0, 0, 0, 
0, 0, 0, 0, 44, 53, 53, 58 },
{ 0, 0, 0, 0, 0, 0, 0, 0, 0, 0, 0, 0, 0, 0, 0, 0, 
0, 0, 0, 0, 0, 0, 0, 0, 0, 0, 0, 0, 0, 0, 0, 0, 
0, 0, 0, 44, 53, 53, 58, 0 },
{ 0, 0, 0, 0, 0, 0, 0, 0, 0, 0, 0, 0, 0, 0, 0, 0, 
0, 0, 0, 0, 0, 0, 0, 0, 0, 0, 0, 0, 0, 0, 0, 0, 
0, 0, 44, 53, 53, 58, 60, 0 },
{ 0, 0, 0, 0, 44, 45, 46, 45, 46, 45, 46, 45, 46, 45, 46, 45, 
46, 48, 0, 0, 0, 0, 0, 0, 0, 0, 44, 45, 45, 45, 45, 45, 
45, 50, 53, 53, 58, 60, 0, 0 },
{ 0, 0, 0, 0, 55, 53, 54, 53, 54, 53, 54, 53, 54, 53, 54, 53, 
54, 57, 48, 0, 0, 0, 0, 0, 0, 43, 53, 54, 53, 54, 53, 54, 
53, 54, 53, 58, 60, 0, 0, 0 },
{ 0, 0, 0, 0, 63, 55, 54, 54, 54, 54, 53, 54, 54, 54, 53, 54, 
54, 54, 57, 48, 0, 0, 0, 0, 0, 63, 55, 53, 54, 53, 54, 53, 
54, 53, 58, 60, 0, 0, 0, 0 },
{ 0, 0, 0, 0, 0, 63, 55, 53, 54, 53, 54, 53, 54, 53, 54, 53, 
54, 53, 54, 57, 48, 0, 0, 0, 0, 0, 63, 62, 61, 62, 61, 62, 
61, 62, 60, 0, 0, 0, 0, 0 },
{ 0, 0, 0, 0, 0, 0, 63, 61, 62, 61, 62, 61, 62, 61, 62, 61, 
62, 61, 62, 61, 57, 48, 0, 0, 0, 0, 0, 0, 0, 0, 0, 0, 
0, 0, 0, 0, 0, 0, 0, 0 },
{ 0, 0, 0, 0, 0, 0, 0, 0, 0, 0, 0, 0, 0, 0, 0, 0, 
0, 0, 0, 0, 0, 49, 0, 0, 0, 0, 0, 0, 0, 0, 0, 0, 
0, 0, 0, 0, 0, 0, 0, 0 },
{ 0, 0, 0, 0, 0, 0, 0, 0, 0, 0, 0, 0, 0, 0, 0, 0, 
0, 0, 0, 0, 0, 56, 0, 0, 0, 0, 0, 0, 0, 0, 0, 0, 
0, 0, 0, 0, 0, 0, 0, 0 },
{ 0, 0, 0, 0, 0, 0, 0, 0, 0, 0, 0, 0, 0, 0, 0, 0, 
0, 0, 0, 0, 0, 49, 0, 0, 0, 0, 0, 0, 0, 0, 0, 0, 
0, 0, 0, 0, 0, 0, 0, 0 },
{ 0, 0, 0, 0, 0, 0, 0, 0, 0, 0, 0, 65, 53, 53, 54, 55, 
57, 48, 0, 0, 0, 57, 46, 46, 45, 0, 0, 0, 45, 46, 0, 0, 
0, 0, 0, 0, 0, 0, 0, 0 },
{ 0, 0, 0, 0, 0, 0, 0, 0, 0, 0, 0, 0, 0, 0, 0, 0, 
0, 56, 0, 0, 0, 53, 54, 53, 54, 0, 0, 0, 53, 54, 0, 0, 
0, 0, 0, 0, 0, 0, 0, 0 },
{ 0, 0, 0, 0, 0, 0, 0, 0, 0, 0, 0, 0, 0, 0, 0, 0, 
0, 56, 0, 0, 0, 55, 53, 54, 53, 0, 0, 0, 54, 53, 0, 0, 
0, 0, 0, 0, 0, 0, 0, 0 },
{ 0, 0, 0, 0, 0, 0, 0, 0, 0, 0, 0, 0, 0, 0, 0, 0, 
0, 56, 0, 0, 0, 63, 61, 62, 61, 0, 0, 0, 61, 55, 47, 0, 
0, 0, 0, 0, 0, 0, 0, 0 },
{ 0, 0, 0, 0, 0, 0, 0, 0, 0, 0, 0, 0, 0, 0, 0, 0, 
0, 56, 0, 0, 0, 0, 0, 0, 0, 0, 0, 0, 0, 63, 55, 47, 
0, 0, 0, 0, 0, 0, 0, 0 },
{ 0, 0, 0, 0, 0, 0, 0, 0, 0, 0, 0, 0, 0, 0, 0, 0, 
0, 56, 0, 0, 0, 0, 0, 0, 0, 0, 0, 0, 0, 0, 63, 55, 
47, 0, 0, 0, 0, 0, 0, 0 },
{ 0, 0, 0, 0, 0, 0, 0, 0, 0, 0, 0, 0, 0, 0, 0, 0, 
0, 56, 0, 0, 0, 0, 0, 0, 0, 0, 0, 0, 0, 0, 0, 63, 
55, 47, 0, 0, 0, 0, 0, 0 },
{ 0, 0, 0, 0, 0, 0, 0, 0, 0, 0, 0, 0, 0, 0, 0, 0, 
0, 57, 46, 46, 46, 46, 46, 46, 45, 46, 45, 46, 47, 0, 0, 0, 
63, 55, 54, 53, 53, 53, 53, 53 },
{ 0, 0, 0, 0, 0, 0, 0, 0, 0, 0, 0, 0, 0, 0, 0, 0, 
0, 63, 61, 61, 61, 61, 62, 61, 62, 61, 62, 61, 62, 61, 62, 62, 
61, 61, 61, 62, 61, 62, 61, 62 },
{ 0, 0, 0, 0, 0, 0, 0, 0, 0, 0, 0, 0, 0, 0, 0, 0, 
0, 0, 0, 0, 0, 0, 0, 0, 0, 0, 0, 0, 0, 0, 0, 0, 
105, 106, 107, 0, 0, 0, 0, 0 },
{ 0, 0, 0, 0, 0, 0, 0, 0, 0, 0, 0, 0, 0, 0, 0, 0, 
0, 0, 0, 105, 106, 107, 0, 0, 0, 0, 105, 106, 107, 0, 0, 0, 
108, 109, 110, 0, 0, 0, 0, 0 },
{ 0, 0, 0, 0, 0, 0, 0, 0, 0, 0, 0, 0, 0, 0, 0, 0, 
0, 0, 0, 108, 109, 110, 0, 0, 0, 0, 108, 109, 110, 0, 0, 0, 
111, 112, 113, 0, 105, 106, 107, 0 },
{ 0, 0, 0, 0, 0, 0, 0, 0, 0, 0, 0, 0, 0, 0, 0, 0, 
0, 0, 0, 111, 112, 113, 105, 106, 107, 0, 111, 112, 113, 105, 106, 107, 
0, 114, 0, 0, 108, 109, 110, 0 },
{ 0, 0, 0, 0, 0, 0, 0, 0, 0, 0, 0, 0, 0, 0, 0, 0, 
0, 0, 0, 0, 114, 0, 108, 109, 110, 0, 0, 114, 0, 108, 109, 110, 
0, 0, 0, 0, 111, 112, 113, 0 },
{ 0, 0, 0, 0, 0, 0, 0, 0, 0, 0, 0, 0, 0, 0, 0, 0, 
0, 0, 0, 0, 0, 0, 111, 112, 113, 0, 0, 0, 0, 111, 112, 113, 
0, 105, 106, 107, 0, 114, 0, 0 },
{ 0, 0, 0, 0, 0, 0, 0, 0, 0, 0, 0, 0, 0, 0, 0, 0, 
0, 0, 0, 0, 0, 0, 0, 114, 0, 0, 0, 0, 0, 0, 114, 0, 
0, 108, 109, 110, 0, 105, 106, 107 },
{ 0, 0, 0, 0, 0, 0, 0, 0, 0, 0, 0, 0, 0, 0, 0, 0, 
0, 0, 0, 0, 0, 0, 0, 0, 0, 0, 0, 0, 0, 105, 106, 107, 
0, 111, 112, 113, 0, 108, 109, 110 },
{ 0, 0, 0, 0, 0, 0, 0, 0, 0, 0, 0, 0, 0, 0, 0, 0, 
0, 0, 0, 0, 0, 0, 0, 0, 0, 0, 0, 0, 0, 108, 109, 110, 
0, 0, 114, 0, 0, 111, 112, 113 },
{ 0, 0, 0, 0, 0, 0, 0, 0, 0, 0, 0, 0, 0, 0, 0, 0, 
0, 0, 0, 0, 0, 0, 0, 0, 0, 0, 0, 0, 0, 111, 112, 113, 
0, 0, 0, 0, 0, 0, 114, 0 },
{ 0, 0, 0, 0, 0, 0, 0, 0, 0, 0, 0, 0, 0, 0, 0, 0, 
0, 0, 0, 0, 0, 0, 0, 0, 0, 0, 0, 0, 0, 0, 114, 0, 
0, 105, 106, 107, 0, 0, 0, 0 },
{ 0, 0, 0, 0, 0, 0, 0, 0, 0, 0, 0, 0, 0, 0, 0, 0, 
0, 0, 0, 0, 0, 0, 0, 0, 0, 0, 0, 0, 0, 0, 0, 0, 
0, 108, 109, 110, 0, 0, 0, 0 },
{ 0, 0, 0, 0, 0, 0, 0, 0, 0, 0, 0, 0, 0, 0, 0, 0, 
0, 0, 0, 0, 0, 0, 0, 0, 0, 0, 0, 0, 0, 0, 0, 0, 
0, 111, 112, 113, 0, 0, 0, 0 },
{ 0, 0, 0, 0, 0, 0, 0, 0, 0, 0, 0, 0, 0, 0, 0, 0, 
0, 0, 0, 0, 0, 0, 0, 0, 0, 0, 0, 0, 0, 0, 0, 0, 
0, 0, 114, 0, 0, 0, 0, 0 }
}

