{
{ 0, 0, 0, 0, 0, 0, 0, 0, 0, 0, 0, 0, 0, 0, 0, 0, 
0, 0, 0, 0, 0, 0, 0, 0, 0, 0, 0, 0, 0, 0, 0, 0, 
0, 10, 10, 10, 10, 10, 10, 10 },
{ 0, 0, 0, 0, 0, 0, 0, 0, 0, 0, 0, 0, 0, 0, 0, 0, 
0, 0, 0, 0, 0, 0, 0, 0, 0, 0, 0, 0, 0, 0, 0, 0, 
0, 10, 10, 10, 10, 10, 10, 10 },
{ 0, 0, 0, 0, 0, 0, 0, 0, 0, 0, 0, 0, 0, 0, 0, 0, 
0, 0, 0, 0, 0, 0, 0, 0, 0, 0, 0, 0, 0, 0, 0, 0, 
0, 10, 10, 10, 10, 10, 10, 10 },
{ 0, 0, 0, 0, 0, 0, 0, 0, 0, 0, 0, 0, 0, 0, 0, 0, 
0, 0, 0, 0, 0, 0, 0, 0, 0, 0, 0, 0, 0, 0, 0, 0, 
0, 10, 10, 10, 10, 10, 10, 10 },
{ 0, 0, 0, 0, 0, 0, 0, 0, 0, 0, 0, 0, 0, 0, 0, 0, 
0, 0, 0, 0, 0, 0, 0, 0, 0, 0, 0, 0, 0, 0, 0, 0, 
0, 10, 10, 10, 10, 10, 10, 10 },
{ 0, 0, 0, 0, 0, 0, 0, 0, 0, 0, 0, 0, 0, 0, 0, 0, 
0, 0, 0, 0, 0, 0, 0, 0, 0, 0, 0, 0, 0, 0, 0, 0, 
0, 10, 10, 10, 10, 10, 10, 10 },
{ 0, 0, 0, 0, 0, 0, 0, 0, 0, 0, 0, 0, 0, 0, 0, 0, 
0, 0, 0, 0, 0, 0, 0, 0, 0, 0, 0, 0, 0, 0, 0, 0, 
0, 10, 10, 10, 10, 10, 10, 10 },
{ 0, 0, 0, 0, 0, 0, 0, 0, 0, 0, 0, 0, 0, 0, 0, 0, 
0, 0, 0, 0, 0, 0, 0, 0, 0, 0, 0, 0, 0, 0, 0, 0, 
0, 10, 10, 10, 10, 10, 10, 10 },
{ 0, 0, 0, 0, 0, 0, 0, 0, 0, 0, 0, 0, 0, 0, 0, 0, 
0, 0, 0, 0, 0, 0, 0, 0, 0, 0, 0, 0, 0, 0, 0, 0, 
0, 10, 10, 10, 10, 10, 10, 10 },
{ 0, 0, 0, 0, 0, 0, 0, 0, 0, 0, 0, 0, 0, 0, 0, 0, 
0, 0, 0, 0, 0, 0, 0, 0, 0, 0, 0, 0, 0, 0, 0, 0, 
0, 10, 10, 10, 10, 10, 10, 10 },
{ 0, 0, 0, 0, 0, 0, 0, 0, 0, 0, 0, 0, 0, 0, 0, 0, 
0, 0, 0, 0, 0, 0, 0, 0, 0, 0, 0, 0, 0, 0, 0, 0, 
0, 10, 10, 10, 10, 10, 10, 10 },
{ 0, 0, 0, 0, 0, 0, 0, 0, 0, 0, 0, 0, 0, 0, 0, 0, 
0, 0, 0, 0, 0, 0, 0, 0, 0, 0, 0, 0, 0, 0, 0, 0, 
0, 10, 10, 10, 10, 10, 10, 10 },
{ 0, 0, 0, 0, 0, 0, 0, 0, 0, 0, 0, 0, 0, 0, 0, 0, 
0, 0, 0, 0, 0, 0, 0, 0, 0, 0, 0, 0, 0, 0, 0, 0, 
0, 10, 10, 10, 10, 10, 10, 10 },
{ 0, 0, 0, 0, 0, 0, 0, 0, 0, 0, 0, 0, 0, 0, 0, 0, 
0, 0, 0, 0, 0, 0, 0, 0, 0, 0, 0, 0, 0, 0, 0, 0, 
0, 10, 10, 10, 10, 10, 10, 10 },
{ 0, 0, 0, 0, 0, 0, 0, 0, 0, 0, 0, 0, 0, 0, 0, 0, 
0, 0, 0, 0, 0, 0, 0, 0, 0, 0, 0, 0, 0, 0, 0, 0, 
0, 10, 10, 10, 10, 10, 10, 10 },
{ 0, 0, 0, 0, 0, 0, 0, 0, 0, 0, 0, 0, 0, 0, 0, 0, 
0, 0, 0, 0, 0, 0, 0, 0, 0, 0, 0, 0, 0, 0, 0, 0, 
0, 10, 10, 10, 10, 10, 10, 10 },
{ 0, 0, 0, 0, 0, 0, 0, 0, 0, 0, 0, 0, 0, 0, 0, 0, 
0, 0, 0, 0, 0, 0, 0, 0, 0, 0, 0, 0, 0, 0, 0, 0, 
0, 0, 0, 0, 0, 0, 0, 0 },
{ 0, 0, 0, 0, 0, 0, 0, 0, 0, 0, 0, 0, 0, 0, 0, 0, 
0, 0, 0, 0, 0, 0, 0, 0, 0, 0, 0, 0, 0, 0, 0, 0, 
0, 0, 0, 0, 0, 0, 0, 0 },
{ 0, 0, 0, 0, 0, 0, 0, 0, 0, 0, 0, 0, 0, 0, 0, 0, 
0, 0, 0, 0, 0, 0, 0, 0, 0, 0, 0, 0, 0, 0, 0, 0, 
0, 0, 0, 0, 0, 0, 0, 0 },
{ 0, 0, 0, 0, 0, 0, 0, 0, 0, 0, 0, 0, 0, 0, 0, 0, 
0, 0, 0, 0, 0, 0, 0, 0, 0, 0, 0, 0, 0, 0, 0, 0, 
0, 0, 0, 0, 0, 0, 0, 0 },
{ 0, 0, 0, 0, 0, 0, 0, 0, 0, 0, 0, 0, 0, 0, 0, 0, 
0, 0, 0, 0, 0, 0, 0, 0, 0, 0, 0, 0, 0, 0, 0, 0, 
0, 0, 0, 0, 0, 0, 0, 0 },
{ 0, 0, 0, 0, 0, 0, 0, 0, 0, 0, 0, 0, 0, 0, 0, 0, 
0, 0, 0, 0, 0, 0, 0, 0, 0, 0, 0, 0, 0, 0, 0, 0, 
0, 0, 0, 0, 0, 0, 0, 0 },
{ 0, 0, 0, 0, 0, 0, 0, 0, 0, 0, 0, 0, 0, 0, 0, 0, 
0, 0, 0, 0, 0, 0, 0, 0, 0, 0, 0, 0, 0, 0, 0, 0, 
0, 0, 0, 0, 0, 0, 0, 0 },
{ 0, 0, 0, 0, 0, 0, 0, 0, 0, 0, 0, 0, 0, 0, 0, 0, 
0, 0, 0, 0, 0, 0, 0, 0, 0, 0, 0, 0, 0, 0, 0, 0, 
0, 0, 0, 0, 0, 0, 0, 0 },
{ 0, 0, 0, 0, 0, 0, 0, 0, 0, 0, 0, 0, 0, 0, 0, 0, 
0, 0, 0, 0, 0, 0, 0, 0, 0, 0, 0, 0, 0, 0, 0, 0, 
0, 0, 0, 0, 0, 0, 0, 0 },
{ 0, 0, 0, 0, 0, 0, 0, 0, 0, 0, 0, 0, 0, 0, 0, 0, 
0, 0, 0, 0, 0, 0, 0, 0, 0, 0, 0, 0, 0, 0, 0, 0, 
0, 10, 10, 10, 10, 10, 10, 10 },
{ 0, 0, 0, 0, 0, 0, 0, 0, 0, 0, 0, 0, 0, 0, 0, 0, 
0, 0, 0, 0, 0, 0, 0, 0, 0, 0, 0, 0, 0, 0, 0, 0, 
0, 10, 10, 10, 10, 10, 10, 10 },
{ 0, 0, 0, 0, 0, 0, 0, 0, 0, 0, 0, 0, 0, 0, 0, 0, 
0, 0, 0, 0, 0, 0, 0, 0, 0, 0, 0, 0, 0, 0, 0, 0, 
0, 10, 10, 10, 10, 10, 10, 10 },
{ 0, 0, 0, 0, 0, 0, 0, 0, 0, 0, 0, 0, 0, 0, 0, 0, 
0, 0, 0, 0, 0, 0, 0, 0, 0, 0, 0, 0, 0, 0, 0, 0, 
0, 10, 10, 10, 10, 10, 10, 10 },
{ 0, 0, 0, 0, 0, 0, 0, 0, 0, 0, 0, 0, 0, 0, 0, 0, 
0, 0, 0, 0, 0, 0, 0, 0, 0, 0, 0, 0, 0, 0, 0, 0, 
0, 10, 10, 10, 10, 10, 10, 10 },
{ 0, 0, 0, 0, 0, 0, 0, 0, 0, 0, 0, 0, 0, 0, 0, 0, 
0, 0, 0, 0, 0, 0, 0, 0, 0, 0, 0, 0, 0, 0, 0, 0, 
0, 10, 10, 10, 10, 10, 10, 10 },
{ 0, 0, 0, 0, 0, 0, 0, 0, 0, 0, 0, 0, 0, 0, 0, 0, 
0, 0, 0, 0, 0, 0, 0, 0, 0, 0, 0, 0, 0, 0, 0, 0, 
0, 10, 10, 10, 10, 10, 10, 10 },
{ 0, 0, 0, 0, 0, 0, 0, 0, 0, 0, 0, 0, 0, 0, 0, 0, 
0, 0, 0, 0, 0, 0, 0, 0, 0, 0, 0, 0, 0, 0, 0, 0, 
0, 10, 10, 10, 10, 10, 10, 10 },
{ 0, 0, 0, 0, 0, 0, 0, 0, 0, 0, 0, 0, 0, 0, 0, 0, 
0, 0, 0, 0, 0, 0, 0, 0, 0, 0, 0, 0, 0, 0, 0, 0, 
0, 10, 10, 10, 10, 10, 10, 10 },
{ 0, 0, 0, 0, 0, 0, 0, 0, 0, 0, 0, 0, 0, 0, 0, 0, 
0, 0, 0, 0, 0, 0, 0, 0, 0, 0, 0, 0, 0, 0, 0, 0, 
0, 10, 10, 10, 10, 10, 10, 10 },
{ 0, 0, 0, 0, 0, 0, 0, 0, 0, 0, 0, 0, 0, 0, 0, 0, 
0, 0, 0, 0, 0, 0, 0, 0, 0, 0, 0, 0, 0, 0, 0, 0, 
0, 10, 10, 10, 10, 10, 10, 10 },
{ 0, 0, 0, 0, 0, 0, 0, 0, 0, 0, 0, 0, 0, 0, 0, 0, 
0, 0, 0, 0, 0, 0, 0, 0, 0, 0, 0, 0, 0, 0, 0, 0, 
0, 10, 10, 10, 10, 10, 10, 10 },
{ 0, 0, 0, 0, 0, 0, 0, 0, 0, 0, 0, 0, 0, 0, 0, 0, 
0, 0, 0, 0, 0, 0, 0, 0, 0, 0, 0, 0, 0, 0, 0, 0, 
0, 10, 10, 10, 10, 10, 10, 10 },
{ 0, 0, 0, 0, 0, 0, 0, 0, 0, 0, 0, 0, 0, 0, 0, 0, 
0, 0, 0, 0, 0, 0, 0, 0, 0, 0, 0, 0, 0, 0, 0, 0, 
0, 10, 10, 10, 10, 10, 10, 10 },
{ 0, 0, 0, 0, 0, 0, 0, 0, 0, 0, 0, 0, 0, 0, 0, 0, 
0, 0, 0, 0, 0, 0, 0, 0, 0, 0, 0, 0, 0, 0, 0, 0, 
0, 10, 10, 10, 10, 10, 10, 10 }
};
{
{ 4, 4, 4, 4, 8, 8, 8, 8, 4, 4, 8, 4, 4, 4, 4, 4, 
4, 8, 8, 8, 8, 4, 4, 4, 4, 4, 1, 1, 1, 1, 1, 1, 
1, 0, 0, 0, 0, 0, 0, 0 },
{ 4, 4, 4, 4, 8, 4, 8, 8, 8, 8, 8, 8, 8, 4, 4, 4, 
4, 8, 4, 8, 8, 8, 8, 4, 4, 4, 1, 1, 1, 1, 1, 1, 
1, 0, 0, 0, 0, 0, 0, 0 },
{ 4, 4, 4, 4, 8, 4, 4, 8, 8, 8, 8, 8, 8, 4, 4, 4, 
4, 8, 4, 4, 8, 8, 8, 4, 4, 4, 1, 1, 1, 1, 1, 1, 
1, 0, 0, 0, 0, 0, 0, 0 },
{ 4, 4, 4, 4, 8, 8, 4, 8, 8, 8, 8, 8, 8, 4, 4, 4, 
4, 8, 8, 4, 8, 8, 8, 4, 4, 4, 1, 1, 1, 1, 1, 1, 
1, 0, 0, 0, 0, 0, 0, 0 },
{ 4, 4, 4, 4, 8, 8, 8, 4, 8, 8, 4, 8, 8, 4, 4, 4, 
4, 8, 8, 8, 4, 8, 8, 4, 4, 4, 1, 1, 1, 1, 1, 1, 
1, 0, 0, 0, 0, 0, 0, 0 },
{ 4, 4, 4, 4, 4, 8, 8, 4, 8, 8, 4, 8, 8, 4, 4, 16, 
16, 4, 8, 8, 4, 8, 8, 4, 4, 4, 1, 1, 1, 1, 1, 1, 
1, 0, 0, 0, 0, 0, 0, 0 },
{ 4, 4, 4, 8, 8, 4, 4, 4, 8, 8, 4, 8, 8, 4, 4, 16, 
16, 8, 4, 4, 4, 8, 8, 4, 4, 4, 1, 1, 1, 1, 1, 1, 
1, 0, 0, 0, 0, 0, 0, 0 },
{ 4, 4, 4, 8, 8, 8, 4, 4, 8, 8, 4, 8, 8, 4, 4, 16, 
16, 8, 8, 4, 4, 8, 8, 4, 4, 4, 1, 1, 1, 1, 1, 1, 
1, 0, 0, 0, 0, 0, 0, 0 },
{ 4, 4, 4, 8, 8, 8, 8, 8, 8, 8, 8, 8, 8, 4, 4, 4, 
4, 8, 8, 8, 8, 8, 8, 4, 4, 4, 1, 1, 1, 1, 1, 1, 
1, 0, 0, 0, 0, 0, 0, 0 },
{ 4, 4, 4, 4, 8, 8, 8, 4, 4, 4, 4, 8, 8, 8, 8, 4, 
4, 8, 8, 8, 8, 4, 4, 4, 4, 4, 1, 1, 1, 1, 1, 1, 
1, 0, 0, 0, 0, 0, 0, 0 },
{ 4, 4, 4, 4, 8, 8, 8, 4, 4, 4, 4, 8, 4, 8, 8, 8, 
8, 8, 4, 8, 8, 8, 8, 4, 4, 4, 1, 1, 1, 1, 1, 1, 
1, 0, 0, 0, 0, 0, 0, 0 },
{ 4, 4, 4, 4, 4, 8, 8, 4, 4, 4, 4, 8, 4, 4, 8, 8, 
8, 8, 4, 4, 8, 8, 8, 4, 4, 4, 1, 1, 1, 1, 1, 1, 
1, 0, 0, 0, 0, 0, 0, 0 },
{ 4, 4, 4, 4, 4, 8, 8, 4, 4, 4, 4, 8, 8, 4, 8, 8, 
8, 8, 8, 4, 8, 8, 8, 4, 4, 4, 1, 1, 1, 1, 1, 1, 
1, 0, 0, 0, 0, 0, 0, 0 },
{ 4, 4, 4, 4, 4, 8, 4, 4, 4, 4, 4, 8, 8, 8, 4, 8, 
8, 8, 8, 8, 4, 8, 8, 4, 4, 4, 1, 1, 1, 1, 1, 1, 
1, 0, 0, 0, 0, 0, 0, 0 },
{ 4, 4, 4, 4, 4, 8, 4, 4, 4, 4, 4, 4, 8, 8, 4, 8, 
8, 4, 8, 8, 4, 8, 8, 4, 4, 4, 1, 1, 1, 1, 1, 1, 
1, 0, 0, 0, 0, 0, 0, 0 },
{ 4, 4, 4, 4, 4, 8, 8, 4, 4, 4, 8, 8, 4, 4, 4, 8, 
8, 8, 4, 4, 4, 8, 8, 4, 4, 4, 1, 1, 1, 1, 1, 1, 
1, 0, 0, 0, 0, 0, 0, 0 },
{ 16, 16, 16, 16, 4, 8, 8, 4, 4, 4, 8, 16, 16, 16, 16, 8, 
8, 8, 8, 4, 4, 8, 8, 4, 4, 4, 16, 16, 16, 8, 4, 8, 
8, 5, 5, 5, 5, 5, 5, 5 },
{ 16, 16, 16, 16, 4, 4, 8, 4, 4, 4, 8, 16, 16, 16, 16, 8, 
8, 8, 8, 8, 8, 8, 8, 4, 4, 4, 16, 16, 16, 8, 4, 8, 
8, 5, 5, 5, 5, 5, 5, 5 },
{ 16, 16, 16, 16, 8, 8, 4, 4, 4, 4, 8, 16, 16, 16, 16, 4, 
8, 8, 8, 8, 8, 4, 4, 4, 4, 4, 16, 16, 16, 4, 4, 8, 
8, 5, 5, 5, 5, 5, 5, 5 },
{ 16, 16, 16, 16, 8, 8, 1, 1, 1, 8, 8, 16, 16, 16, 16, 8, 
4, 8, 4, 8, 8, 8, 8, 4, 4, 4, 16, 16, 16, 4, 4, 8, 
8, 5, 5, 5, 5, 5, 5, 5 },
{ 16, 4, 16, 16, 8, 8, 1, 1, 1, 8, 8, 16, 16, 16, 16, 8, 
4, 8, 4, 4, 8, 8, 8, 4, 4, 4, 16, 16, 16, 8, 8, 8, 
8, 5, 5, 5, 5, 5, 5, 5 },
{ 16, 16, 16, 16, 8, 8, 4, 4, 4, 4, 8, 16, 16, 16, 16, 8, 
4, 8, 8, 4, 8, 8, 8, 4, 4, 4, 16, 16, 16, 8, 4, 8, 
8, 5, 5, 5, 5, 5, 5, 5 },
{ 16, 16, 16, 16, 8, 8, 4, 4, 4, 4, 8, 16, 16, 16, 16, 8, 
4, 8, 8, 8, 4, 8, 8, 4, 4, 4, 16, 16, 16, 4, 4, 8, 
8, 5, 5, 5, 5, 5, 5, 5 },
{ 16, 16, 16, 16, 8, 8, 4, 4, 4, 4, 4, 16, 16, 16, 16, 8, 
4, 4, 8, 8, 4, 8, 8, 4, 4, 4, 16, 16, 16, 4, 4, 8, 
8, 5, 5, 5, 5, 5, 5, 5 },
{ 16, 16, 16, 16, 8, 8, 4, 4, 4, 8, 8, 16, 16, 16, 16, 8, 
8, 8, 4, 4, 4, 8, 8, 4, 4, 4, 16, 16, 16, 8, 8, 8, 
8, 5, 5, 5, 5, 5, 5, 5 },
{ 4, 4, 4, 4, 8, 4, 4, 4, 4, 8, 8, 8, 4, 4, 8, 8, 
8, 8, 8, 4, 4, 8, 8, 4, 4, 4, 1, 1, 1, 1, 1, 1, 
1, 0, 0, 0, 0, 0, 0, 0 },
{ 4, 4, 4, 4, 8, 4, 4, 4, 4, 8, 8, 8, 8, 8, 8, 8, 
8, 8, 8, 8, 4, 4, 8, 4, 4, 4, 1, 1, 1, 1, 1, 1, 
1, 0, 0, 0, 0, 0, 0, 0 },
{ 4, 4, 4, 4, 8, 8, 4, 4, 4, 4, 8, 8, 8, 8, 4, 4, 
4, 4, 8, 8, 8, 8, 4, 4, 4, 4, 1, 1, 1, 1, 1, 1, 
1, 0, 0, 0, 0, 0, 0, 0 },
{ 4, 4, 4, 4, 8, 8, 4, 4, 4, 4, 8, 4, 8, 8, 8, 8, 
4, 4, 8, 4, 8, 8, 8, 8, 4, 4, 1, 1, 1, 1, 1, 1, 
1, 0, 0, 0, 0, 0, 0, 0 },
{ 4, 4, 4, 4, 4, 8, 4, 4, 4, 4, 8, 4, 4, 8, 8, 8, 
4, 4, 8, 4, 4, 8, 8, 8, 4, 4, 1, 1, 1, 1, 1, 1, 
1, 0, 0, 0, 0, 0, 0, 0 },
{ 4, 4, 4, 8, 8, 4, 4, 4, 4, 4, 8, 8, 4, 8, 8, 8, 
4, 4, 8, 8, 4, 8, 8, 8, 4, 4, 1, 1, 1, 1, 1, 1, 
1, 0, 0, 0, 0, 0, 0, 0 },
{ 4, 4, 4, 8, 8, 8, 4, 4, 4, 4, 8, 8, 8, 4, 8, 8, 
4, 4, 8, 8, 8, 4, 8, 8, 4, 4, 1, 1, 1, 1, 1, 1, 
1, 0, 0, 0, 0, 0, 0, 0 },
{ 4, 4, 4, 8, 8, 8, 4, 4, 4, 4, 4, 8, 8, 4, 8, 8, 
4, 4, 4, 8, 8, 8, 8, 4, 4, 4, 1, 1, 1, 1, 1, 1, 
1, 0, 0, 0, 0, 0, 0, 0 },
{ 4, 4, 4, 4, 8, 8, 4, 4, 4, 8, 8, 4, 4, 4, 8, 8, 
4, 4, 8, 8, 8, 8, 4, 4, 8, 4, 1, 1, 1, 1, 1, 1, 
1, 0, 0, 0, 0, 0, 0, 0 },
{ 4, 4, 4, 4, 8, 8, 4, 4, 4, 0, 12, 13, 13, 13, 0, 8, 
4, 4, 8, 4, 8, 8, 8, 8, 8, 4, 1, 1, 1, 1, 1, 1, 
1, 0, 0, 0, 0, 0, 0, 0 },
{ 4, 4, 4, 4, 4, 8, 4, 4, 4, 8, 8, 8, 8, 8, 8, 8, 
4, 4, 8, 4, 4, 8, 8, 8, 8, 4, 1, 1, 1, 1, 1, 1, 
1, 0, 0, 0, 0, 0, 0, 0 },
{ 4, 4, 4, 8, 8, 4, 4, 4, 8, 8, 4, 8, 4, 8, 8, 8, 
8, 4, 8, 8, 4, 8, 8, 8, 8, 4, 1, 1, 1, 1, 1, 1, 
1, 0, 0, 0, 0, 0, 0, 0 },
{ 4, 4, 4, 8, 8, 8, 4, 4, 8, 8, 4, 8, 4, 4, 8, 8, 
8, 4, 8, 8, 8, 4, 8, 8, 8, 4, 1, 1, 1, 1, 1, 1, 
1, 0, 0, 0, 0, 0, 0, 0 },
{ 4, 4, 4, 8, 8, 8, 8, 8, 8, 8, 4, 8, 8, 4, 8, 8, 
8, 4, 4, 8, 8, 4, 8, 8, 8, 4, 1, 1, 1, 1, 1, 1, 
1, 0, 0, 0, 0, 0, 0, 0 },
{ 4, 4, 4, 4, 8, 8, 8, 8, 4, 4, 4, 8, 8, 8, 4, 8, 
8, 8, 8, 4, 4, 4, 8, 8, 8, 4, 1, 1, 1, 1, 1, 1, 
1, 0, 0, 0, 0, 0, 0, 0 }
};
{
{ 0, 0, 0, 0, 0, 57, 58, 59, 0, 0, 0, 34, 35, 36, 0, 0, 
0, 0, 0, 0, 0, 0, 0, 0, 0, 7, 0, 0, 0, 0, 0, 0, 
0, 0, 0, 0, 0, 0, 0, 0 },
{ 0, 0, 0, 0, 60, 61, 62, 63, 0, 0, 37, 38, 39, 40, 0, 0, 
0, 0, 0, 0, 0, 0, 0, 0, 0, 7, 0, 0, 0, 0, 0, 0, 
0, 0, 0, 0, 0, 0, 0, 0 },
{ 0, 0, 0, 0, 64, 65, 66, 67, 0, 41, 42, 43, 44, 45, 0, 0, 
0, 0, 0, 0, 0, 0, 0, 0, 0, 7, 0, 0, 0, 0, 0, 0, 
0, 0, 0, 0, 0, 0, 0, 0 },
{ 0, 0, 0, 0, 68, 69, 70, 71, 46, 47, 48, 49, 50, 51, 0, 0, 
0, 0, 0, 0, 0, 0, 0, 0, 0, 7, 0, 0, 0, 0, 0, 0, 
0, 0, 0, 0, 0, 0, 0, 0 },
{ 0, 0, 0, 0, 72, 73, 74, 75, 0, 52, 53, 54, 55, 56, 0, 0, 
0, 0, 0, 0, 0, 0, 0, 0, 0, 7, 0, 0, 0, 0, 0, 0, 
0, 0, 0, 0, 0, 0, 0, 0 },
{ 0, 0, 0, 0, 0, 0, 0, 0, 0, 0, 0, 0, 0, 0, 0, 0, 
0, 0, 0, 0, 0, 0, 0, 0, 0, 7, 0, 0, 0, 0, 0, 0, 
0, 0, 0, 0, 0, 0, 0, 0 },
{ 0, 0, 0, 0, 0, 0, 0, 0, 0, 0, 0, 0, 0, 0, 0, 0, 
0, 0, 0, 0, 0, 0, 0, 0, 0, 7, 0, 0, 0, 0, 0, 0, 
0, 0, 0, 0, 0, 0, 0, 0 },
{ 0, 0, 0, 0, 0, 0, 0, 0, 0, 0, 0, 0, 0, 0, 0, 0, 
0, 0, 0, 0, 0, 0, 0, 0, 0, 7, 0, 0, 0, 0, 0, 0, 
0, 0, 0, 0, 0, 0, 0, 0 },
{ 0, 0, 0, 34, 35, 36, 0, 0, 0, 34, 35, 36, 0, 0, 0, 0, 
7, 0, 0, 0, 0, 0, 0, 0, 0, 7, 0, 0, 0, 0, 0, 0, 
0, 0, 0, 0, 0, 0, 0, 0 },
{ 0, 0, 37, 38, 39, 40, 0, 0, 37, 38, 39, 40, 0, 0, 0, 0, 
7, 0, 0, 0, 0, 0, 0, 0, 0, 7, 0, 0, 0, 0, 0, 0, 
0, 0, 0, 0, 0, 0, 0, 0 },
{ 0, 41, 42, 43, 44, 45, 0, 41, 42, 43, 44, 45, 0, 0, 0, 0, 
7, 0, 0, 0, 0, 0, 0, 0, 0, 7, 0, 0, 0, 0, 0, 0, 
0, 0, 0, 0, 0, 0, 0, 0 },
{ 46, 47, 48, 49, 50, 51, 46, 47, 48, 49, 50, 51, 0, 0, 0, 0, 
7, 0, 0, 0, 0, 0, 0, 0, 0, 7, 0, 0, 0, 0, 0, 0, 
0, 0, 0, 0, 0, 0, 0, 0 },
{ 0, 52, 53, 54, 55, 56, 0, 52, 53, 54, 55, 56, 0, 0, 0, 0, 
7, 0, 0, 0, 0, 0, 0, 0, 0, 7, 0, 0, 0, 0, 0, 0, 
0, 0, 0, 0, 0, 0, 0, 0 },
{ 0, 0, 0, 0, 0, 0, 0, 0, 0, 0, 0, 0, 0, 0, 0, 0, 
7, 0, 0, 0, 0, 0, 0, 0, 0, 7, 0, 0, 0, 0, 0, 0, 
0, 0, 0, 0, 0, 0, 0, 0 },
{ 0, 0, 0, 0, 0, 0, 0, 0, 0, 0, 0, 0, 0, 0, 0, 0, 
7, 0, 0, 0, 0, 0, 0, 0, 0, 7, 0, 0, 0, 0, 0, 0, 
0, 0, 0, 0, 0, 0, 0, 0 },
{ 0, 0, 0, 0, 0, 0, 0, 0, 0, 0, 0, 18, 18, 18, 18, 18, 
17, 0, 0, 0, 0, 0, 0, 0, 0, 17, 0, 0, 0, 0, 0, 0, 
0, 0, 0, 0, 0, 0, 0, 0 },
{ 0, 0, 0, 0, 0, 0, 0, 0, 0, 0, 0, 0, 0, 0, 0, 0, 
0, 0, 0, 0, 0, 0, 0, 0, 0, 0, 0, 0, 0, 0, 0, 0, 
0, 0, 0, 0, 0, 0, 0, 0 },
{ 0, 0, 0, 0, 0, 0, 0, 0, 0, 0, 0, 0, 0, 0, 0, 0, 
0, 0, 0, 0, 0, 0, 0, 0, 0, 0, 0, 0, 0, 0, 0, 0, 
0, 0, 0, 0, 0, 0, 0, 0 },
{ 0, 0, 0, 0, 0, 7, 7, 7, 7, 7, 0, 0, 0, 0, 0, 0, 
0, 0, 0, 0, 0, 0, 0, 0, 0, 0, 0, 0, 0, 0, 0, 0, 
0, 0, 0, 0, 0, 0, 0, 0 },
{ 0, 0, 0, 0, 0, 7, 0, 0, 0, 7, 0, 0, 0, 0, 0, 0, 
0, 0, 0, 0, 0, 0, 0, 0, 0, 0, 0, 0, 0, 0, 0, 0, 
0, 0, 0, 0, 0, 0, 0, 0 },
{ 0, 0, 0, 0, 0, 7, 0, 0, 0, 7, 0, 0, 0, 0, 0, 0, 
0, 0, 0, 0, 0, 0, 0, 0, 0, 0, 0, 0, 0, 0, 0, 0, 
0, 0, 0, 0, 0, 0, 0, 0 },
{ 0, 0, 0, 0, 0, 17, 18, 18, 18, 17, 0, 0, 0, 0, 0, 0, 
0, 0, 0, 0, 0, 0, 0, 0, 0, 0, 0, 0, 0, 0, 0, 0, 
0, 0, 0, 0, 0, 0, 0, 0 },
{ 0, 0, 0, 0, 0, 0, 0, 0, 0, 0, 0, 0, 0, 0, 0, 0, 
0, 0, 0, 0, 0, 0, 0, 0, 0, 0, 0, 0, 0, 0, 0, 0, 
0, 0, 0, 0, 0, 0, 0, 0 },
{ 0, 0, 0, 0, 0, 0, 0, 0, 0, 0, 0, 0, 0, 0, 0, 0, 
0, 0, 0, 0, 0, 0, 0, 0, 0, 0, 0, 0, 0, 0, 0, 0, 
0, 0, 0, 0, 0, 0, 0, 0 },
{ 0, 0, 0, 0, 0, 0, 0, 0, 0, 0, 0, 0, 0, 0, 0, 0, 
0, 0, 0, 0, 0, 0, 0, 0, 0, 0, 0, 0, 0, 0, 0, 0, 
0, 0, 0, 0, 0, 0, 0, 0 },
{ 0, 0, 0, 0, 0, 0, 0, 0, 0, 0, 0, 18, 18, 18, 18, 18, 
17, 0, 0, 0, 0, 0, 0, 0, 0, 7, 0, 0, 0, 0, 0, 0, 
0, 0, 0, 0, 0, 0, 0, 0 },
{ 0, 0, 0, 0, 0, 0, 0, 34, 35, 36, 0, 0, 57, 58, 59, 0, 
7, 0, 0, 0, 0, 0, 0, 0, 0, 7, 0, 0, 0, 0, 0, 0, 
0, 0, 0, 0, 0, 0, 0, 0 },
{ 0, 0, 0, 0, 0, 0, 37, 38, 39, 40, 0, 60, 61, 62, 63, 0, 
7, 0, 0, 0, 0, 0, 0, 0, 0, 7, 0, 0, 0, 0, 0, 0, 
0, 0, 0, 0, 0, 0, 0, 0 },
{ 0, 0, 0, 0, 0, 41, 42, 43, 44, 45, 0, 64, 65, 66, 67, 0, 
7, 0, 0, 0, 0, 0, 0, 0, 0, 7, 0, 0, 0, 0, 0, 0, 
0, 0, 0, 0, 0, 0, 0, 0 },
{ 0, 0, 0, 0, 46, 47, 48, 49, 50, 51, 0, 68, 69, 70, 71, 0, 
7, 0, 0, 0, 0, 0, 0, 0, 0, 7, 0, 0, 0, 0, 0, 0, 
0, 0, 0, 0, 0, 0, 0, 0 },
{ 0, 0, 0, 0, 0, 52, 53, 54, 55, 56, 0, 72, 73, 74, 75, 0, 
7, 0, 0, 0, 0, 0, 0, 0, 0, 7, 0, 0, 0, 0, 0, 0, 
0, 0, 0, 0, 0, 0, 0, 0 },
{ 0, 0, 0, 0, 0, 0, 0, 0, 0, 0, 0, 0, 0, 0, 0, 0, 
7, 0, 0, 0, 0, 0, 0, 0, 0, 7, 0, 0, 0, 0, 0, 0, 
0, 0, 0, 0, 0, 0, 0, 0 },
{ 0, 0, 0, 0, 0, 0, 0, 0, 0, 0, 0, 0, 0, 0, 0, 0, 
7, 0, 0, 0, 0, 0, 0, 0, 0, 7, 0, 0, 0, 0, 0, 0, 
0, 0, 0, 0, 0, 0, 0, 0 },
{ 0, 0, 0, 0, 0, 0, 0, 0, 0, 0, 0, 0, 0, 0, 0, 0, 
7, 0, 0, 0, 0, 0, 0, 0, 0, 7, 0, 0, 0, 0, 0, 0, 
0, 0, 0, 0, 0, 0, 0, 0 },
{ 18, 18, 18, 18, 18, 18, 18, 18, 18, 18, 0, 0, 0, 0, 18, 18, 
17, 0, 0, 0, 0, 0, 0, 0, 0, 7, 0, 0, 0, 0, 0, 0, 
0, 0, 0, 0, 0, 0, 0, 0 },
{ 0, 0, 0, 0, 0, 0, 0, 0, 0, 0, 0, 0, 0, 0, 0, 0, 
0, 0, 0, 0, 0, 0, 0, 0, 0, 7, 0, 0, 0, 0, 0, 0, 
0, 0, 0, 0, 0, 0, 0, 0 },
{ 0, 0, 0, 0, 0, 0, 0, 0, 0, 0, 0, 0, 0, 0, 0, 0, 
0, 0, 0, 0, 0, 0, 0, 0, 0, 7, 0, 0, 0, 0, 0, 0, 
0, 0, 0, 0, 0, 0, 0, 0 },
{ 0, 0, 0, 0, 0, 0, 0, 0, 0, 0, 0, 0, 0, 0, 0, 0, 
0, 0, 0, 0, 0, 0, 0, 0, 0, 7, 0, 0, 0, 0, 0, 0, 
0, 0, 0, 0, 0, 0, 0, 0 },
{ 0, 0, 0, 0, 0, 0, 0, 0, 0, 0, 0, 0, 0, 0, 0, 0, 
0, 0, 0, 0, 0, 0, 0, 0, 0, 7, 0, 0, 0, 0, 0, 0, 
0, 0, 0, 0, 0, 0, 0, 0 },
{ 0, 0, 0, 0, 0, 0, 0, 0, 0, 0, 0, 0, 0, 0, 0, 0, 
0, 0, 0, 0, 0, 0, 0, 0, 0, 7, 0, 0, 0, 0, 0, 0, 
0, 0, 0, 0, 0, 0, 0, 0 }
}

